cigar: knoll these puppy rabbi acrid vicar cigar
rebut: along dizzy sperm fewer retch rebut
sissy: along queer thick fizzy wimpy biddy sissy
humph: along dizzy tweet crumb humus humph
awake: front dizzy sauce blame heave agape awake
blush: front dizzy jewel caulk plump slush blush
focal: spite jumbo known ardor coach local vocal focal
evade: front spice gauge blame awake heave evade
naval: shift jumbo wedge crack apply naval
serve: along dizzy crept femur verse serve
heath: knoll dizzy queer masse begat teach heath
dwarf: knoll segue tatty briar chard dwarf
model: chaff tying skulk revel dowel model
karma: shift along cedar quark parka karma
stink: chaff jumbo eerie dizzy spilt sting stink
grade: shift jumbo apnea leaky craze grave grade
quiet: along speck femme truer duvet quiet
bench: first llama judge woken penny bench
abate: humor fanny sepia evade glaze awake abate
feign: humor tacit dizzy spill eking feign
major: shift bulky weave agora razor manor major
death: knoll spice matey treat heath death
fresh: along dizzy ester purse cress fresh
crust: along dizzy fewer shrub usurp truss crust
stool: chaff dizzy jumbo rover known gloss spool stool
colon: shift wryly ledge plunk banal colon
abase: front dizzy lapel quake shave cease abase
marry: shift along wrack rarer parry marry
react: knoll dizzy umbra paper grace reach react
batty: humor aside fanny wacky gayly tatty patty batty
pride: along shuck fewer bribe tripe prize prime pride
floss: drank ethic jumbo lowly spool gloss floss
helix: front slump badly level welch helix
croak: shift gaudy leave apron cobra croak
staff: humor dizzy kappa angst stave stall staff
paper: shift along dread rearm carve baker payer paper
unfed: prowl tatty sheik begun dunce unfed
whelp: front dizzy amuse belch wheel whelp
trawl: spice fanny augur board wrath trawl
outdo: chaff wryly genie stoop motto outdo
adobe: shift pluck waxen dread beady adobe
crazy: shift along radar brake cramp crazy
sower: chaff tying jumbo erode rover poker loser sower
repay: shift along maker brave recap repay
digit: chaff jumbo penne twirl kitty visit digit
crate: knoll dizzy umbra paper grave erase trace crate
cluck: front dizzy amass level gulch pluck cluck
spike: along dummy witch bribe seize spike
mimic: along queer fifth wispy civic mimic
pound: chaff wryly kiosk buxom vogue pound
maxim: front segue dizzy khaki axial maxim
linen: chaff jumbo wedge spent vixen liken linen
unmet: chaff wryly spike detox event unmet
flesh: drank jumbo twixt level cycle flesh
booby: chaff slump never dodgy boozy booty booby
forth: spice along jumbo toddy rotor worth forth
first: along beech dusty skirt first
stand: humor jiffy weave spank slang scant stand
belly: chaff outdo spike never leggy jelly belly
ivory: chaff slump tweed brink rigor ivory
seedy: along ethic queue freed weedy seedy
print: chaff jumbo girly tried wrist print
yearn: shift jumbo radar crave pearl weary yearn
drain: segue tatty mocha frank prawn brain drain
bribe: along shuck fewer prize trite drive bribe
stout: chaff wryly genie buxom joust spout stout
panel: shift jumbo cedar angel navel panel
crass: knoll dizzy umbra waver trash grass crass
flume: drank stilt belch glove plume flume
offal: spice tatty board along offal
agree: shift jumbo drawl recap gayer agree
error: chaff tying jumbo dowel spore error
swirl: chaff jumbo tying spied skill swirl
argue: shift knoll mercy paper bread grave argue
bleed: chaff tying rover jewel sleep bleed
delta: humor fanny glass apple ideal delta
flick: humor tatty wedge blink slick click flick
totem: chaff wryly kiosk junto detox totem
wooer: chaff stern giver purer ember older joker wooer
front: spice jumbo goody atoll thorn front
shrub: along dizzy fewer spurt scrum shrub
parry: shift along cedar rumba parry
biome: chaff wryly spent vogue oxide biome
lapel: front dizzy glass caulk valve label lapel
start: knoll dizzy gruff meter apart chart start
greet: chaff jumbo spike level greed green greet
goner: chaff slump jetty erode rover boxer goner
golem: chaff dizzy retro loose vowel golem
lusty: chaff penne roomy dizzy buggy sulky lusty
loopy: chaff segue ditto known roomy booby loopy
round: chaff pixel buggy mount sound wound round
audit: knoll beech gypsy mamma friar audit
lying: chaff jumbo steep dingy vying lying
gamma: front dizzy swash value kappa magma gamma
labor: shift penne rowdy groom carol valor labor
islet: chaff jumbo wedge plier liken islet
civic: along queer shift picky mimic civic
forge: junta wryly sperm rider verge gorge forge
corny: shift llama wedge puppy boozy rocky corny
moult: chaff dizzy penne outgo trout joust moult
basic: front apply weave mamma basis basic
salad: front pluck leave basil sally salsa salad
agate: humor fanny sepia blaze evade awake agate
spicy: along defer thumb sissy spiky spicy
spray: knoll abide mamma grass straw scrap spray
essay: front medic quell shave askew essay
fjord: spice llama buggy worth frond fjord
spend: chaff jumbo giver pesky slept spend
kebab: front dizzy humph abase bagel kebab
guild: chaff spoon melee wryly built quill guild
aback: front dizzy segue clamp whack aback
motor: chaff pixel rugby drown torso motor
alone: shift wryly expel value blame algae alone
hatch: knoll dizzy augur theta stash batch watch catch match patch hatch
hyper: along first wreck ember udder hyper
thumb: along dizzy queue stuck trump thumb
dowry: chaff slump onion voter wordy dowry
ought: drank spice folly jumbo quoth ought
belch: front slump vigil ladle welch belch
dutch: along riper mushy hutch butch dutch
pilot: chaff segue known bobby primo pivot pilot
tweed: along spice hefty truer tweet tweed
comet: drank fully hippo moose totem comet
jaunt: spice wryly doubt vaunt haunt gaunt taunt jaunt
enema: shift gaudy rebar plane annex enema
steed: along jiffy humph beset ester steed
abyss: front valid champ kebab abyss
growl: chaff dizzy jumbo evoke swoop wrong growl
fling: humor tacit dizzy exile blink sling fling
dozen: chaff slump jetty error ovine woken dozen
boozy: chaff slump never dodgy booby booty boozy
erode: chaff stern ruler grime probe drove erode
world: chaff tying jumbo sloop dowel world
gouge: chaff wryly kiosk tempo dozen vogue gouge
click: front segue dizzy cavil chili climb click
briar: knoll segue tatty wharf circa briar
great: knoll dizzy umbra paper crave treat great
altar: spice fanny rumba drawl altar
pulpy: chaff stork wedge bunny mummy puppy pulpy
blurt: chaff dizzy wrong queer slurp blurb blurt
coast: penne wryly vivid jumbo shoot toast coast
duchy: along ester jiffy mummy puppy buddy duchy
groin: chaff slump tweed kinky onion robin groin
fixer: along erupt mercy skier diver fiber fixer
group: chaff dizzy bevel skunk juror trout group
rogue: chaff stern idler jerky probe rouge rogue
badly: front slump level chalk gaily badly
smart: knoll dizzy fever chart quart apart start smart
pithy: along queer jiffy sissy biddy wimpy picky pithy
gaudy: front pixel swash kayak mammy jazzy cabby daddy gaudy
chill: front slump valid exile icily chill
heron: apply evict guess rodeo froze heron
vodka: shift queer apply wagon comma vodka
finer: adopt bulky which siege vixen miner finer
surer: along dizzy crept verse shrew surer
radio: segue chaff kappa tawny maxim rabid radii radio
rouge: chaff stern idler jerky probe rogue rouge
perch: along dizzy wrest ember curve perch
retch: along dizzy sperm verve rebut retch
wrote: chaff slump onion joker grove erode wrote
clock: shift wryly melee along blood clock
tilde: chaff jumbo wring visit ditty tilde
store: chaff deign boule evoke swore spore store
prove: chaff stern ruder jerky grime probe prove
bring: chaff slump rowdy enter brink bring
solve: chaff tying lemur dwell slope solve
cheat: knoll dizzy parer stage theta wheat cheat
grime: chaff stern rover jerky prize bride grime
exult: chaff dizzy spoon revel bulge exult
usher: along dizzy crept reuse surer usher
epoch: drank slimy fugue tweet epoch
triad: knoll segue happy affix vicar triad
break: shift along paper craze dream wreak break
rhino: segue llama dowry frock throb rhino
viral: segue fanny chart ardor rival viral
conic: segue wryly kappa fifth onion ionic conic
masse: front dizzy chuck weave apple masse
sonic: relay jumbo widow going conic tonic ionic sonic
vital: humor fanny glass pedal axial vital
trace: knoll dizzy umbra paper grave erase crate trace
using: chaff wryly motto dense spunk using
peach: front dizzy llama shake beach peach
champ: front dizzy bugle macaw smack champ
baton: spice wryly vodka among banjo baton
brake: shift along paper bread brave brace brake
pluck: front dizzy amass level gulch cluck pluck
craze: shift along paper rearm brake crave craze
gripe: chaff stern rover jerky bride prime gripe
weary: shift along paper brake rearm weary
picky: along queer bitty sissy fizzy hippy picky
acute: knoll dizzy eager steam teach acute
ferry: along spice teeth jerky berry merry ferry
aside: front belly check equip image waive aside
tapir: knoll segue which dizzy affix trait tapir
troll: chaff dizzy penne burst motor troll
unify: prowl amass debit cinch vying unify
rebus: along dizzy theft purer revue rebus
boost: chaff wryly minus pesto stood boost
truss: along dizzy fewer shrub usurp crust truss
siege: chaff jumbo dryer spent swell sieve siege
tiger: chaff jumbo wryly never skier riper tiger
banal: shift wryly melee cloak pupal naval banal
slump: chaff tying world level plumb slump
crank: shift jumbo wedge papal crazy crack crank
gorge: chaff stern ruder prize merge gorge
query: along shift dryer jerky every query
drink: chaff jumbo silly tripe grind drink
favor: spice jumbo thong royal ardor favor
abbey: front medic quell agape askew abbey
tangy: humor abide stack fatal tawny tangy
panic: humor swell dizzy faint cabin panic
solar: penne dizzy chart augur favor molar solar
shire: along dummy eject river bribe spire shire
proxy: chaff stilt wedge jumbo poppy proxy
point: chaff wryly segue motto toxin joint point
robot: chaff slump evoke going rowdy rotor robot
prick: along teeth dizzy skiff crick brick prick
wince: humor tatty blind vixen niece since wince
crimp: along teeth dizzy squib prick crimp
knoll: chaff dizzy jumbo voter snoop known knoll
sugar: knoll dizzy reset brash scram sugar
whack: front dizzy segue kappa clack whack
mount: chaff wryly vivid tepee outgo stout mount
perky: along shift embed wreck jerky perky
could: shift penne brawl gloom jolly could
wrung: chaff pixel stood rugby wrung
light: drank jumbo spice fight tight wight light
those: drank fully spice goose whose those
moist: chaff wryly penne stood gusto joist moist
shard: knoll fruit rebar march sharp shard
pleat: humor fanny aside begat eclat pleat
aloft: spice jumbo rowdy along aloof aloft
skill: chaff jumbo never giddy spilt swill skill
elder: chaff stern giver purer wooer ember elder
frame: knoll dizzy threw spear brave grace frame
humor: spice flown board juror tumor humor
pause: front dizzy beech algae quake mauve pause
ulcer: shift amaze never dryer power bluer ulcer
ultra: spice booby rajah frank augur ultra
robin: chaff slump wedge kinky onion toxin robin
cynic: humor pasta wedge flick civic cynic
agora: shift bulky weave nomad cargo agora
aroma: shift gaudy weave zonal arbor aroma
caulk: front dizzy glass valve cabal caulk
shake: front dizzy basal swash shape shave shame shake
pupal: front dizzy melee glass cabal pupal
dodge: chaff slump joint woozy rover dodge
swill: chaff jumbo never silky spilt swill
tacit: humor penne skill fifty await tacit
other: apply deign cress ember tower outer other
thorn: spice jumbo dolly favor wrong thorn
trove: chaff slump onion joker drove grove trove
bloke: chaff tying lemur dowel slope bloke
vivid: along queer fifth wispy mimic vivid
spill: chaff jumbo never silky still swill spill
chant: segue dizzy proof macaw black chant
choke: first gaudy below ozone evoke choke
rupee: along shift wreck merry upper rupee
nasty: humor abide flack jazzy savvy pasty tasty nasty
mourn: chaff pixel buggy strut drunk mourn
ahead: front spicy bevel gauze ahead
brine: chaff slump rowdy tiger eerie bribe brine
cloth: drank gypsy femme quoth tooth cloth
hoard: spice flown jumbo tarot ovary hoard
sweet: along dizzy chuck verse steep sweet
month: spice wryly abbot outdo thong month
lapse: front dizzy chuck weave amble lapse
watch: knoll dizzy augur theta stash batch hatch catch match patch watch
today: spice flown humor bobby dodgy today
focus: drank pixel motto bobby cough focus
smelt: chaff deign purer solve swell smelt
tease: humor fanny adage plate stave tease
cater: knoll dizzy segue paper waver rarer tamer hater cater
movie: chaff wryly spent budge evoke movie
lynch: first jumbo delve plank lynch
saute: knoll dizzy beach wafer mauve gauge pause saute
allow: shift gaudy knave comma arbor allow
renew: chaff jumbo spike exert never renew
their: along bused petty erect their
slosh: drank jiffy queue whoop cloth slosh
purge: chaff stern rower bride merge purge
chest: along dizzy purer femme check chess chest
depot: chaff wryly kiosk jumbo dodge detox depot
epoxy: chaff deign swell totem broke epoxy
nymph: first adage block mummy nymph
found: spice wryly mambo ought found
shall: front dizzy melee lupus slash shawl shall
harry: knoll segue tacit mamma paddy jazzy harry
stove: chaff wryly minus stoop stoke stove
lowly: chaff segue point moody lorry lobby lowly
snout: chaff wryly vivid tepee gusto joust stout snout
trope: chaff deign boule store wrote trove trope
fewer: along dizzy shrub creep refer fever fewer
shawl: front dizzy melee caulk alpha shawl
natal: humor dizzy glass fable canal naval natal
fibre: along shuck remit pried fiery fibre
comma: shift gaudy weave arbor zonal comma
foray: spice jumbo known dodgy hotly foray
scare: knoll dizzy erupt waver rearm share scare
stair: knoll beech gaudy pizza affix trait stair
black: front dizzy melee laugh clasp black
squad: front pixel baggy awash sumac squad
royal: shift penne jumbo clock godly loyal royal
chunk: first llama wedge booby hunch chunk
mince: float bused verge pixie niche wince mince
slave: front dizzy humph basal glass slack slave
shame: front dizzy basal swash shake shave shape shame
cheek: along dizzy fetus emcee creep cheek
ample: front dizzy glass equal cable apple ample
flair: segue tatty vodka charm prawn flair
foyer: junta spice embed hover wooer roger foyer
cargo: shift bulky rover drown macro cargo
oxide: chaff slump jetty rover endow diode oxide
plant: humor dizzy basal clang flank plane plant
olive: chaff erupt wedge biome noise olive
inert: chaff jumbo wryly sprig diner inert
askew: front dizzy peach vague bleak askew
heist: along fuzzy embed wreck pixie heist
shown: abide flock gross stony snoop shown
zesty: along chide refer setup testy zesty
hasty: knoll abide gamut catty party hasty
trash: knoll dizzy umbra waver grasp crass trash
fella: humor tying bless pedal leave fella
larva: shift jumbo wedge prank carry larva
forgo: spice knoll board forum forty forgo
story: chaff pixel jumbo wrong roost stork story
hairy: knoll segue taffy mammy daddy jazzy cabby happy harry hairy
train: segue vodka apply march briar trait train
homer: junta wryly giver defer corer sober poker homer
badge: front spice melee awake gauze badge
midst: along beech puppy skirt visit midst
canny: shift jumbo grave kayak daddy nanny canny
fetus: along chide empty truer quest fetus
butch: along dizzy sweet thump hutch butch
farce: knoll dizzy erupt rehab wager carve farce
slung: chaff dizzy ester swoop skunk slung
tipsy: along queer whiff mimic biddy sixty tipsy
metal: frown dizzy glass apple label equal metal
yield: chaff jumbo sprig index tilde wield yield
delve: chaff tying sloop lemur bezel delve
being: chaff slump video write eking being
scour: abide nutty chump focus scour
glass: front dizzy melee pupal black slash glass
gamer: shift knoll cedar paper wager gayer gazer gamer
scrap: knoll dizzy umbra waver grass strap scrap
money: chaff stilt queue rover dopey gooey boney money
hinge: float bused verve whine niche hinge
album: front dizzy kappa swash legal album
vouch: drank pixel fussy mouth cough vouch
asset: humor fanny plate stead asset
tiara: knoll segue which vivid fizzy tiara
crept: along dizzy shrub wreck creme crept
bayou: shift grape madam canny bayou
atoll: spice fanny dogma arrow about atoll
manor: shift bulky weave agora razor major manor
creak: shift along paper brave dream wreak creak
showy: drank pixel jumbo scoff sooth showy
phase: front dizzy basal askew shave chase phase
froth: spice jumbo dolly razor grown froth
depth: along jiffy stuck tweet berth depth
gloom: chaff dizzy penne worst jumbo gloom
flood: spice jumbo lorry atoll flown flood
trait: knoll segue which dizzy mafia trait
girth: knoll amass tepid itchy fifth birth girth
piety: along sushi mimic biddy fifty kitty piety
payer: shift along dread rearm carve baker paper payer
goose: chaff wryly minus steed posse goose
float: spice jumbo rowdy atoll gloat float
donor: chaff slump evoke orbit worry donor
atone: pluck dizzy swash magma rebar annex atone
primo: chaff segue blown vomit idiom primo
apron: shift gaudy llama break acorn apron
blown: chaff dizzy joust venom wrong known blown
cacao: shift queer apply vodka wagon mambo cacao
loser: chaff tying jumbo erode rover poker sower loser
input: chaff wryly embed sting toxin input
gloat: spice fanny brawl adult gloat
awful: spice tatty broad llama annul awful
brink: chaff slump wedge toxin ninny brink
smite: along fuzzy cheek debit tripe smite
beady: front shuck maxim plead adage beady
rusty: along beech jiffy puppy musky dusty rusty
retro: chaff slump dizzy brook gorge owner retro
droll: chaff tying jumbo sword erode drool droll
gawky: front pixel duchy assay jazzy mammy baggy gawky
hutch: along dizzy sweet thump butch hutch
pinto: chaff wryly segue idiot toxin pinto
gaily: front slump level chalk badly gayly gaily
egret: chaff jumbo spike never greed egret
lilac: front slump bevel child lilac
sever: along dizzy humph wreck beret refer sever
field: humor tacit spiky vixen bilge wield field
fluff: drank spice bully ghoul fluff
hydro: spice flown buxom aorta hydro
flack: humor tying lapel black clack slack flack
agape: front dizzy sauce blame heave awake agape
wench: first jumbo agape kneed newly wench
voice: drank fully teeth posse booze movie voice
stead: humor fanny plate asset steak stead
stalk: humor fanny alibi leapt stall stalk
berth: along dizzy sperm fewer rebut berth
madam: front pixel buggy awash mamma madam
night: prowl amass queue dizzy fifth tight night
bland: shift wryly melee pupal clang blank bland
liver: chaff stern purer ember wooer giver diver liver
wedge: chaff jumbo pixel testy verve wedge
augur: shift knoll jazzy crave rumba augur
roomy: chaff pixel donut soggy booby woozy roomy
wacky: front pixel amass gaudy jazzy cabby wacky
flock: spite jumbo arrow goody chock knock flock
angry: shift jumbo revel wrack parry angry
bobby: chaff slump never dizzy booby bobby
trite: along shuck fewer prize bribe drive trite
aphid: front segue wacky llama aphid
tryst: along emcee fifth spurt tryst
midge: chaff wryly spoon debit guide midge
power: chaff stern giver dryer bluer joker wooer mower power
elope: chaff tying lemur dowel bloke slope elope
cinch: segue wryly kappa motto vivid finch cinch
motto: chaff wryly genie stoop outdo motto
stomp: chaff wryly genie doubt stoop stomp
upset: along chide retry swept upset
bluff: drank spice tooth gully fluff bluff
cramp: shift along radar brake crazy cramp
quart: knoll dizzy fever chart smart apart quart
coyly: drank slump level wooly hotly coyly
youth: drank pixel bosom couch tough youth
rhyme: along first breed recur rhyme
buggy: chaff pixel stood gummy rugby buggy
alien: humor gypsy tweak leave abled alien
smear: knoll dizzy erupt verge safer swear shear smear
unfit: prowl amass dizzy chick genie unfit
patty: humor abide fanny wacky savvy gayly jazzy tatty patty
cling: humor tatty pixel blind sling fling cling
glean: shift jumbo wryly level plane clean glean
label: front slump icily jewel gavel hazel label
hunky: first llama bongo penne hunch hunky
khaki: front segue dizzy iliac maxim khaki
poker: chaff stern giver dryer bluer wooer joker poker
gruel: chaff stern verve rodeo plier gruel
twice: along bused petty eject trice twice
twang: humor bevel dandy knack stain twang
shrug: knoll tacit embed pushy shush shrug
treat: knoll dizzy usage mecca earth after treat
unlit: chaff gypsy broom elude quill unlit
waste: humor dizzy apnea cleat stave baste taste waste
merit: along shuck dizzy tripe refit merit
woven: chaff slump jetty diode roger woken woven
octal: segue fanny alarm villa total octal
needy: chaff jumbo pixel serve geeky weedy needy
clown: shift queer kappa dolly gloom blown clown
widow: chaff slump egret bobby onion widow
irony: chaff segue world primo orbit irony
ruder: along shift wreck ember upper ruder
gauze: front spice melee budge vague gauze
chief: along squib dizzy twixt crimp chick chief
onset: chaff wryly vivid jumbo spoon onset
prize: along shuck fewer bribe tripe pride prime prize
fungi: prowl tatty embed chuck using fungi
charm: knoll dizzy fever trump scram charm
gully: chaff spoon tweed murky buggy gully
inter: chaff jumbo wedge spell vixen inner inter
whoop: drank fully geese mimic tooth whoop
taunt: spice wryly doubt vaunt haunt jaunt gaunt taunt
leery: chaff jumbo spike tenet weedy leery
class: front dizzy melee laugh black clasp class
theme: along dizzy purer eject teeth these theme
lofty: drank slump vigil belch wooly lofty
tibia: humor penne idyll skiff cacti await tibia
booze: chaff tying jewel prove smoke booze
alpha: front dizzy melee caulk slash alpha
thyme: along bused erect petty thyme
eclat: humor fanny sepia adage bleak eclat
doubt: chaff wryly kiosk venom outdo doubt
parer: shift along dread waver maker caper payer parer
chute: along dizzy steep rebut chute
stick: along queer dizzy swish skiff stick
trice: along bused rhyme prize write trice
alike: front gaudy leash apple alive alike
sooth: drank pixel jumbo goofy tooth sooth
recap: shift along maker brave repay recap
saint: humor bevel dizzy tacit faint paint saint
liege: chaff jumbo dryer swine pixie title liege
glory: chaff penne vivid jumbo rotor gross glory
grate: knoll dizzy beech waver spare frame grate
admit: knoll segue which jiffy rabid admit
brisk: along teeth dizzy crimp frisk brisk
soggy: chaff pixel jumbo worry goody soggy
usurp: along dizzy fewer shrub crust usurp
scald: front bulky legal clash scalp scald
scorn: abide humor forty prong sworn scorn
leave: front slump wield label leaky leach leave
twine: chaff jumbo idyll viper genie swine twine
sting: chaff jumbo eerie dizzy spilt stink sting
bough: drank pixel fussy couch mouth bough
marsh: knoll dizzy fever tract rajah harsh marsh
sloth: drank jiffy tepee hutch booth sloth
dandy: shift jumbo grave lanky canny dandy
vigor: chaff slump tweed booby rigor vigor
howdy: first llama penne buggy woody dowdy howdy
enjoy: chaff slump ditto woken ebony envoy enjoy
valid: front slump liege chili avail valid
ionic: segue wryly kappa month condo ionic
equal: front dizzy glass apple label equal
unset: chaff wryly movie debut quest upset unset
floor: spice jumbo worth ovary droll floor
catch: knoll dizzy augur theta stash batch watch hatch match patch catch
spade: front climb gassy askew suave shade spade
stein: chaff jumbo dryer geese slept stein
exist: along dummy pitch fritz twist exist
quirk: along beech dizzy strip quirk
denim: chaff wryly onset begun penne denim
grove: chaff stern ruder eerie probe grove
spiel: chaff jumbo tying weird exile spiel
mummy: along shift deuce puppy murky mummy
fault: spice wrong madam batty vault fault
foggy: drank pixel jumbo tooth soggy foggy
flout: drank hippo jolly elbow gloss clout flout
carry: shift along weave kayak mammy paddy jazzy cabby carry
sneak: humor dizzy gavel cease sweat speak sneak
libel: chaff outdo spiky minim liege liver libel
waltz: humor spicy blank ladle fatal waltz
aptly: humor slang lilac fable apply aptly
piney: chaff jumbo wedge islet river piney
inept: chaff jumbo silly deign inter inept
aloud: shift wryly melee papal black along aloud
photo: drank fully beget topic stomp photo
dream: shift along paper craze wreak bread dream
stale: humor fanny agape stave state stake stale
vomit: chaff wryly segue inbox ditto vomit
ombre: chaff tying skull rower drove ombre
fanny: humor abide wacky tatty sappy jazzy gayly nanny fanny
unite: chaff wryly speed vogue butte unite
snarl: hobby tacit adage spark swarm snarl
baker: shift along recap drake maker baker
there: along dizzy serum cheer where there
glyph: front amass civic bezel gully glyph
pooch: drank fully might chess pooch
hippy: along queer bitty sissy fizzy picky wimpy hippy
spell: chaff tying error level quell smell swell spell
folly: drank slump vigil wooly hotly coyly jolly folly
louse: chaff tying embed swore posse louse
gulch: front dizzy amass level pluck gulch
vault: spice wrong madam batty fault vault
godly: chaff queer spiky wooly jolly nobly godly
threw: along dizzy sperm rebut ether threw
fleet: drank jumbo which tepee steel fleet
grave: shift jumbo apnea cedar large graze grave
inane: humor cleft essay agape weave inane
shock: abide wryly stung spoof smock shock
crave: shift along paper rearm brake craze crave
spite: along dummy hitch befit tripe spite
valve: front slump wield excel leaky halve valve
skimp: along queer dizzy swish stiff skimp
claim: front segue billy axial plaid claim
rainy: segue chaff taboo papal mammy daddy jazzy nanny rainy
musty: along defer spicy bushy musky musty
pique: along testy freed juice imbue pique
daddy: front pixel swash kayak baggy jazzy mammy caddy daddy
quasi: front apply macaw suave quash quasi
arise: knoll dummy fewer crept brave arise
aging: humor slate caddy ninja avian aping aging
valet: humor dizzy glass banal latte valet
opium: chaff wryly evoke bingo moist idiom opium
avert: knoll dizzy usage recap earth after avert
stuck: along dizzy queue trust stump stuff stuck
recut: along dizzy brush upper curve recut
mulch: front dizzy swell cluck gulch mulch
genre: chaff jumbo dizzy steer nerve genre
plume: chaff tying error swell melee plume
rifle: adopt bunny wreck serif filer rifle
count: abide wryly stomp outgo touch count
incur: float gypsy medic crick incur
total: spice fanny arbor koala modal total
wrest: along dizzy humph sever cress wrest
mocha: first bulky weave pagan comma mocha
deter: along spice berry fewer meter deter
study: along riper humus stuck stuff study
lover: chaff stern purer ember odder joker wooer lover
safer: knoll dizzy erupt verge amber racer wafer safer
rivet: along shuck beefy pried timer rivet
funny: spice llama toddy buggy hurry fuzzy funky funny
smoke: chaff tying bleed rouse spoke smoke
mound: chaff wryly kiosk vogue doubt pound mound
undue: chaff wryly spite gouge venue undue
sedan: humor pixel gaffe essay stead sedan
pagan: shift jumbo leave caddy parka pagan
swine: chaff jumbo dryer stein singe snipe swine
guile: chaff spoon jetty idler liege guile
gusty: chaff pixel booby murky nutty dusty gusty
equip: along testy check drier imbue equip
tough: drank pixel showy botch mouth tough
canoe: shift bulky prong nomad canon canoe
chaos: penne wryly tacit aback chaff chasm chaos
covet: drank fully hippo smote octet covet
human: first vodka baggy peace annul human
udder: along shift wreck merry rupee udder
lunch: first amaze goody chunk hunch bunch punch lunch
blast: humor fanny leave plaza clack glass blast
stray: knoll abide chaff pasta squat straw stray
manga: shift prowl deuce jazzy magma manga
melee: chaff tying rover bleed expel melee
lefty: drank jumbo which sleep leggy lefty
quick: along defer shush mummy cubic quick
paste: humor dizzy fence stage waste taste baste paste
given: chaff jumbo sleet rider piney vixen given
octet: drank fully hippo smote covet octet
risen: chaff jumbo wedge pixel rivet riser risen
groan: shift bulky weave mamma ardor organ groan
leaky: front slump helix level leggy leaky
grind: chaff jumbo silly twixt pride drink grind
carve: shift along break rearm paper carve
loose: chaff tying embed worse posse louse loose
sadly: front pluck melee avail gayly badly sadly
spilt: chaff jumbo never silky swill stilt spilt
apple: front dizzy glass value ample apple
slack: front dizzy melee pupal chalk black slack
honey: first pluck madam ozone woven boney honey
final: humor apply glass delta cabal final
sheen: float dizzy mucus verse sweep sheen
eerie: along shuck piety drier eerie
minty: chaff segue prowl vivid kinky ninny minty
slick: front amaze buggy vivid swish spill slick
derby: along shift wreck upper verve berry derby
wharf: knoll dizzy geese mamma craft wharf
spelt: chaff jumbo grind tepee slept spelt
coach: first bulky wedge canon comma coach
erupt: along dizzy sheer curve rebut erupt
singe: chaff jumbo dryer stein spine singe
price: along fetus dryer bribe prize prime price
spawn: humor abide tasty glass snack spawn
fairy: knoll segue hatch mamma jazzy daddy parry fairy
jiffy: along queer thick sissy dizzy wimpy jiffy
filmy: drank segue pooch bitty fizzy filly filmy
stack: humor dizzy weave clasp scant stack
chose: drank fully twixt posse obese chose
sleep: chaff tying rover embed jewel sleek sleep
ardor: shift bulky weave cacao dogma adorn ardor
nanny: shift jumbo grave kayak daddy canny nanny
niece: humor tatty blind vixen since niece
woozy: chaff slump never bitty dodgy woozy
handy: first jumbo weave lanky nanny candy dandy handy
grace: shift jumbo apnea leaky grave grade graze grace
ditto: chaff slump green boozy idiot ditto
stank: humor jiffy wedge pasta stack stalk stank
cream: shift along paper brave wreak dread cream
usual: front dizzy melee chalk papal usual
diode: chaff slump jetty rover endow oxide diode
valor: shift penne buggy crock major razor valor
angle: shift jumbo cedar panel ankle angle
ninja: humor slate caddy aping ninja
muddy: along shift revue jumpy mucky muddy
chase: front dizzy basal askew shave phase chase
reply: chaff stern drove lemur peril reply
prone: chaff dizzy jumbo wooer spore trope prove prone
spoil: chaff queer toddy known gloom spoil
heart: knoll dizzy gruff scram paper extra avert heart
shade: front apply maize weave chase shake shade
diner: chaff jumbo wryly skirt riper giver diner
arson: bulge dizzy chart vapor arrow arson
onion: chaff slump wedge kitty robin onion
sleet: chaff jumbo grind swell sleep sleek sleet
dowel: chaff tying jumbo posse wooer vowel dowel
couch: drank pixel fussy mouth bough vouch couch
palsy: front beech vivid gummy assay sappy palsy
bowel: chaff tying slump lower vowel dowel bowel
smile: chaff outdo vying spike seize slime smile
evoke: chaff tying demur bowel spoke evoke
creek: along shift demur every crepe creek
lance: shift jumbo wryly plank naval laden lance
eagle: front slump leaky halve cable eagle
idiot: chaff slump green boozy widow idiot
siren: chaff jumbo wedge pixel riser siren
built: chaff spoon wedge murky quill built
embed: along spice jetty freer embed
award: shift jumbo pence dryly radar award
dross: chaff tying jumbo world erode droop dross
annul: shift wryly melee block naval annul
goody: chaff slump never witty bobby dodgy goody
frown: spice jumbo dolly arrow wrong frown
patio: segue chaff radar waltz tabby paint patio
laden: shift jumbo wryly plank naval lance laden
humid: along beset prick fizzy humid
elite: chaff jumbo dryer penne siege exile elite
lymph: front adage skill clump lymph
edify: along pubic midst fried edify
might: drank fully spite wight tight might
reset: along dizzy humph wreck verve refer reset
visit: along defer quick tipsy sixth visit
gusto: chaff wryly penne stood joist gusto
purse: along dizzy theft sewer curse purse
vapor: shift bulky grand racer major vapor
crock: shift llama never gourd proxy brook crock
write: along shuck dizzy bribe prime trite write
sunny: chaff pixel booby gummy dusty sunny
loath: spice fanny broad aglow koala loath
chaff: knoll dizzy augur mamma swath heave chaff
slide: chaff jumbo tying drill plied elide slide
queer: along shift mercy upper ruder queer
venom: chaff wryly kiosk outgo dozen venom
stamp: knoll dizzy augur swash stave staff stamp
sorry: chaff pixel outdo known bobby mossy soggy sorry
still: chaff jumbo never silky spill swill still
acorn: shift gaudy llama break apron acorn
aping: humor slate caddy ninja avian aging aping
pushy: along defer thick mushy bushy pushy
tamer: knoll dizzy segue paper waver rarer cater tamer
hater: knoll dizzy segue paper waver rarer tamer cater hater
mania: segue chaff taboo daddy larva kappa mamma mania
awoke: shift gaudy llama recap annex above awoke
brawn: shift vodka parry augur cream brawl brawn
swift: along queer dizzy stick smith swift
exile: chaff jumbo tying prize elide exile
birch: along fuzzy deter crimp birch
lucky: front amass bleed quill gulch lucky
freer: along dizzy shrub exert creep freer
risky: along beech wimpy ditty jiffy sissy risky
ghost: drank pixel jumbo woozy scoff ghost
plier: chaff stern buyer wooer giver idler plier
lunar: shift vodka apply crawl baler lunar
winch: segue draft jolly cinch pinch winch
snare: hobby tacit flake agape weave snare
nurse: chaff dizzy lover sperm rebus nurse
house: drank pilot booby vogue mouse house
borax: shift gaudy weave comma polar borax
nicer: float gypsy queer rider miner nicer
lurch: abide snout plump gully lurch
exalt: humor fanny sepia abled glaze exalt
about: spice fanny modal abbot abort about
savvy: front pixel whack gaudy jazzy mammy sassy savvy
toxin: chaff slump wedge kinky onion robin toxin
tunic: prowl gaffe shush muddy quick cubic tunic
pried: along shuck eerie rivet fried dried pried
inlay: humor speed aback taint final inlay
chump: along dizzy queue truth chuck chump
lanky: shift jumbo grave dandy canny lanky
cress: along dizzy humph fever wreck crest cress
eater: knoll dizzy usage paper waver cater hater eater
elude: chaff tying bosom upper quell elude
cycle: front slump livid wheel belly cycle
kitty: along queer which sissy fifty bitty ditty kitty
boule: chaff tying odder elope solve boule
moron: chaff pixel rugby stork donor moron
tenet: chaff jumbo spike elegy never tenet
place: front dizzy skulk level gleam place
lobby: chaff segue point woody jolly lorry lobby
plush: front dizzy aback quell slump plush
vigil: chaff jumbo penne skirt willy livid vigil
index: chaff jumbo silly tepid drive index
blink: chaff outdo sweep ninny brink blink
clung: shift wryly melee blond plank clung
qualm: front dizzy weave aback slash qualm
croup: shift llama never rowdy brook group croup
clink: humor tatty wedge spill cliff click clink
juicy: along ester fuzzy dumpy juicy
stage: humor fanny spade slate stave stake stage
decay: front impel guess heave kebab decay
nerve: chaff jumbo wryly river serve verve nerve
flier: adopt shuck berry infer filer flier
shaft: knoll dizzy augur cache swath shaft
crook: shift llama never rowdy croup crock crook
clean: shift jumbo wryly level plane glean clean
china: segue tatty brawl admin ninja china
ridge: chaff stern lover prize eerie ridge
vowel: chaff tying jumbo posse wooer dowel vowel
gnome: chaff wryly spite queue booze gnome
snuck: float dizzy upper shush swung snuck
icing: humor tatty sieve flick icing
spiny: chaff jumbo eerie idyll tipsy spiky spiny
rigor: chaff slump tweed booby vigor rigor
snail: humor caddy weave spank stain snail
flown: spice jumbo lorry atoll flood flown
rabid: knoll segue chaff tatty mamma radii rapid rabid
prose: chaff tying jumbo dowel evoke spore prose
thank: spice fully brood mamma twang thank
poppy: chaff stilt never jumbo goody poppy
budge: chaff wryly onion upset queue judge budge
fiber: along erupt mercy skier diver fixer fiber
moldy: chaff segue point booby lorry dolly moldy
dowdy: chaff slump never kitty boozy dodgy dowdy
kneel: chaff jumbo dizzy verge tweet sleep kneel
track: segue flown dizzy mamma chart track
caddy: front pixel swash kayak baggy jazzy mammy daddy caddy
quell: chaff tying solve bezel dwell quell
dumpy: along shift revue muddy dummy dumpy
paler: shift jumbo drank eager parer paper payer paler
swore: chaff tying bleed serum spore swore
rebar: shift along wacky brave zebra debar rebar
scuba: front dizzy eagle awash sumac scuba
splat: humor jiffy wedge knack basal splat
flyer: adopt binge wreck surer lever flyer
horny: spice jumbo alloy toddy goofy worry horny
mason: bulge hippo vodka afoot rayon canon mason
doing: chaff slump eerie kinky joint going doing
ozone: chaff slump jetty roger evoke diode ozone
amply: front segue valid plaza apply amply
molar: shift gaudy wrack zebra apron molar
ovary: shift penne jumbo world crock razor ovary
beset: along dizzy mucus steep ester beset
queue: along shift muddy rupee queue
cliff: drank jumbo sweep light icily cliff
magic: front apply swash badge magma magic
truce: along dizzy sperm utter rebut truce
sport: chaff dizzy jumbo knoll trove roost sport
fritz: along beech jumpy vivid skirt fritz
edict: along fuzzy steep berth twice evict edict
twirl: chaff jumbo penne livid krill swirl twirl
verse: along dizzy crept femur serve verse
llama: front dizzy weave quack smash llama
eaten: humor dizzy slave pecan waxen taken eaten
range: shift jumbo drawl carry gazer range
whisk: along defer cubic tipsy swish whisk
hovel: drank slump icily betel vowel hovel
rehab: knoll dizzy erupt waver scare rehab
macaw: front dizzy skull agape mamma macaw
sigma: front beech apply madam swami sigma
spout: chaff wryly genie buxom joust stout spout
verve: along shift wreck upper berry verve
sushi: along defer picky twixt squib sushi
dying: chaff jumbo steep idyll dingy dying
fetid: along mucky steep trite befit fetid
brain: segue tatty vodka chaff alarm prawn brain
buddy: along shift revue mummy puppy buddy
thump: along dizzy queue brush chuck thump
scion: relay humph vivid twixt going onion scion
candy: shift jumbo grave kayak dally paddy candy
chord: spite jumbo woozy along crock chord
basin: humor delve jiffy await basic basis basin
march: knoll dizzy gruff apart waver harsh march
crowd: shift llama buggy rover crook crown crowd
arbor: shift gaudy llama ocean arrow arbor
gayly: front slump level chalk badly gaily gayly
musky: along defer spicy bushy musty musky
stain: humor bevel pinky faint antic stain
dally: front slump vigil leech bylaw dally
bless: chaff tying error quell sleep bless
bravo: shift gaudy alarm craze prawn bravo
stung: chaff wryly vivid noose skunk stunt stung
title: chaff jumbo dryer spike genie title
ruler: chaff stern giver wooer ember upper ruder ruler
kiosk: chaff wryly penne jumbo idiot kiosk
blond: chaff segue twixt polyp droll blood blond
ennui: chaff wryly stood pixie eking ennui
layer: shift jumbo drank paper wager rarer layer
fluid: penne chart mogul sulky bluff fluid
tatty: humor abide fanny wacky sappy gayly jazzy tatty
score: junta wryly riper gorge ombre chore score
cutie: along seedy fixer imbue juice cutie
zebra: shift along paper wreak rearm zebra
barge: shift knoll dryer curve merge barge
matey: knoll spice debug theta water matey
bluer: chaff stern giver dryer mower upper bluer
aider: knoll erupt mercy giver wiser fiber rider aider
shook: abide wryly stung scoff spook shook
river: along erupt mercy skier fiber wider river
privy: along deuce fifth skimp privy
betel: chaff dizzy spoon melee level jewel rebel betel
frisk: along beech jumpy vivid twixt skiff frisk
bongo: chaff slump vivid rotor boozy bongo
begun: chaff wryly spike event demon begun
azure: shift knoll mercy dread wager azure
weave: front dizzy sauce apple heave weave
genie: chaff jumbo dryer spike liege genie
sound: chaff wryly sieve spunk stunt sound
glove: chaff dizzy jumbo known troll loose elope glove
braid: knoll segue which jiffy admit vapid braid
scope: drank fully twixt goose shove scope
wryly: chaff jumbo visit kneel dryly wryly
rover: chaff stern eerie bluer mower joker roger rover
assay: front pixel mucus shady gassy assay
ocean: shift gaudy aware pecan clean ocean
bloom: chaff dizzy penne worst gumbo bloom
irate: knoll bused rhyme verve grape craze irate
later: vying jumbo chaff spear eater water later
woken: chaff slump jetty diode roger woven woken
silky: chaff jumbo never dizzy tipsy silly silky
wreck: along shift embed jerky wreck
dwelt: chaff jumbo giver spend weedy dwell dwelt
slate: humor fanny agape evade skate state slate
smack: front dizzy basal shave swamp smack
solid: chaff penne buggy twixt visor solid
amaze: front spice gauge heave blade awake amaze
hazel: front slump wield leave bagel hazel
wrist: along beech jumpy visit swift wrist
jolly: chaff segue point rowdy boozy jolly
globe: chaff dizzy queer tempo solve bloke globe
flint: humor gypsy belie axial click flint
rouse: chaff tying bleed spore worse rouse
civil: front slump badly wheel vigil civil
vista: humor penne flick digit bitty vista
relax: shift jumbo apnea grave cedar relay relax
cover: shift llama buggy erode poker cower corer cover
alive: front gaudy leash apple alike alive
beech: along dizzy quest crepe beech
jetty: along spice embed query hefty jetty
bliss: chaff outdo never wispy skill bliss
vocal: shift wryly melee gland cabal local vocal
often: apply medic error shone woven often
dolly: chaff segue point roomy lowly jolly dolly
eight: drank jumbo silly hitch tight wight fight eight
joker: chaff stern giver purer ember older wooer joker
since: humor tatty blind vixen niece wince since
event: chaff jumbo spike retry tweed event
ensue: chaff wryly vivid bongo spent ensue
shunt: abide floor jumpy skunk swung stunt shunt
diver: along erupt mercy skier fiber rider diver
poser: chaff tying jumbo erode rover sower loser poser
worst: chaff pixel jumbo grown rowdy worst
sweep: along dizzy mucus steer sheep sweep
alley: front medic bugle expel alley
creed: along shift berry wreck creme creep creed
anime: prowl shuck tatty ninja aging avian anime
leafy: humor spice eaten bleak fella leafy
bosom: chaff wryly penne digit jumbo bosom
dunce: shift prowl kayak embed undue dunce
stare: knoll dizzy beech waver argue spare stare
pudgy: chaff knoll verse bitty mummy guppy pudgy
waive: front shuck beady algae maize waive
choir: segue llama rowdy brook thorn choir
stood: chaff wryly minus beset stoop stood
spoke: chaff tying jumbo vowel erode spoke
outgo: chaff wryly kiosk doubt junto outgo
delay: front slump vigil welch jelly delay
bilge: chaff outdo spiky linen bible bilge
ideal: front slump leaky eagle abled ideal
clasp: front dizzy melee laugh black class clasp
seize: along dummy witch bribe spike seize
hotly: drank slump level wooly coyly hotly
laugh: front dizzy melee black pupal laugh
sieve: along pubic width fizzy river sieve
block: shift wryly melee along cloud block
meant: prowl dizzy hatch agate beast meant
grape: shift jumbo never craze drake grape
noose: chaff wryly tepid obese mouse goose noose
hardy: knoll segue tibia macaw jazzy harpy harry hardy
shied: along pubic risky swift seize shied
drawl: shift jumbo kappa gravy craze drawn drawl
daisy: front beech mummy gawky jazzy palsy sassy daisy
putty: along defer shush juicy mummy puppy putty
strut: along dizzy fewer usurp shrub scrum strut
burnt: chaff dizzy sloop never grunt burnt
tulip: chaff known segue muddy quill tulip
crick: along teeth dizzy skiff brick prick crick
idyll: chaff jumbo never twist dizzy idyll
vixen: chaff jumbo wedge spent liner vixen
furor: spice along rowdy throb juror furor
geeky: chaff jumbo pixel serve needy geeky
cough: drank pixel fussy thumb vouch cough
naive: humor cleft index binge spine naive
shoal: penne dizzy jumbo arrow offal local shoal
stork: chaff pixel rowdy juror gross snort storm stork
bathe: knoll dizzy augur smash cheap bathe
aunty: prowl medic gnash vaunt junta aunty
check: along dizzy purer femme chess check
prime: along shuck fewer bribe tripe prize pride prime
brass: knoll dizzy fever trash crass grass brass
outer: chaff deign sperm broke tower otter outer
furry: along beech witty dumpy fussy fuzzy furry
razor: shift bulky weave groan macro razor
elect: drank jumbo zesty lithe fleet elect
evict: along bused retry theme evict
imply: chaff outdo never spiky piggy imply
demur: along shift creep berry demur
quota: spice fanny board atoll quota
haven: first jumbo place knead waxen haven
cavil: front slump liege idyll avail cavil
swear: knoll dizzy erupt verge safer smear shear swear
crump: along dizzy fewer brush truck crump
dough: first llama penne booby couch dough
gavel: front slump wield leaky hazel bagel gavel
wagon: shift queer apply knack nomad banjo wagon
salon: creme dizzy pupal koala aglow talon salon
nudge: chaff wryly onset being nudge
harem: knoll dizzy usage avert recap wafer harem
pitch: along queer swift bitty ditch hitch pitch
sworn: chaff pixel jumbo dodgy known swoon sworn
pupil: chaff stork wedge plumb pulpy pupil
excel: front slump villa wheel bezel excel
stony: chaff pixel jumbo worst stood stony
cabin: humor swell dizzy faint panic cabin
unzip: chaff wryly stood begin minim unzip
queen: chaff wryly spike modem tenet queen
trout: chaff pixel rowdy broom gross trout
polyp: chaff segue ditto broom lowly polyp
earth: knoll dizzy umbra spear trace earth
storm: chaff pixel rowdy juror gross snort stork storm
until: chaff gypsy brood elite limit until
taper: knoll dizzy segue waver rarer cater tamer taper
enter: chaff jumbo spike level tweed egret enter
child: front slump level gayly chili child
adopt: segue fanny brawl comma avoid adopt
minor: chaff segue rowdy broil intro minor
fatty: humor abide snack gayly tatty patty fatty
husky: along defer bitty mummy puppy hussy husky
brave: shift along paper bread brake brace brave
filet: drank jumbo spicy vigil lithe filet
slime: chaff outdo vying spike seize smile slime
glint: chaff queer ovoid wimpy skill blitz glint
tread: knoll spice wafer heard dread bread tread
steal: humor fanny alibi delta exalt steal
regal: shift jumbo apnea crave early relax regal
guest: chaff wryly onion tepee quest guest
every: along shift demur creep every
murky: along shift deuce jumpy murky
share: knoll dizzy erupt waver rearm scare share
spore: chaff tying jumbo dowel evoke prose spore
hoist: drank fully piece moist joist hoist
buxom: chaff wryly kiosk mount jumbo buxom
inner: chaff jumbo wedge spent linen inner
otter: chaff slump grind berry tower otter
dimly: chaff spoon queer bitty giddy dizzy dilly dimly
level: chaff tying slump dowel bezel revel level
sumac: front dizzy eagle awash scuba sumac
donut: chaff wryly kiosk buxom gouge donut
stilt: chaff jumbo never silky swill spilt stilt
arena: shift jumbo repay gazer crave arena
sheet: along dizzy mucus sewer steep sheet
scrub: along dizzy fewer crush scrum scrub
fancy: humor abide papal gawky nasty canny fancy
slimy: chaff outdo penne wryly silky slimy
pearl: shift jumbo radar crave yearn pearl
silly: chaff jumbo never dizzy tipsy silky silly
porch: segue dizzy flown motor cobra porch
dingo: chaff slump eerie ingot going bingo dingo
sepia: front dummy label shape speak sepia
amble: front dizzy glass value apple amble
shady: front pixel mucus assay savvy shaky shady
bread: shift along paper craze wreak dread bread
friar: knoll segue tatty award circa briar friar
reign: chaff jumbo piety exile skier weird reign
dairy: knoll segue chaff mamma tatty jazzy paddy dairy
quill: chaff spoon wedge murky built quill
cross: abide humor forty wrong crock cross
brood: chaff tying slurp rower brook broom brood
tuber: along dizzy sperm revue utter truer tuber
shear: knoll dizzy erupt verge safer smear swear shear
posit: chaff wryly queue inbox ditto moist posit
blank: shift wryly melee pupal clang bland blank
villa: front slump bezel child willy villa
shank: prowl dizzy usage staff smash shack shank
piggy: chaff jumbo never dizzy willy sissy kitty piggy
freak: vying jumbo chart paper relax dread wreak freak
which: along queer dizzy skiff twixt which
among: shift queer jazzy knack gonad along among
fecal: humor tying bless level pedal fecal
shell: front dizzy agape level quell smell swell shell
would: chaff penne skirt gloom jolly would
algae: front dizzy sauce weave apple algae
large: shift jumbo apnea decay glaze eagle large
rabbi: knoll segue chaff tatty mamma vapid rabbi
agony: shift queer black nomad wagon agony
amuse: front dizzy lapel kebab shave amuse
bushy: along defer thick mushy pushy bushy
copse: drank fully twixt obese goose posse copse
swoon: chaff pixel jumbo dodgy known sworn swoon
knife: humor tacit dizzy spill being knife
pouch: drank swell vomit boozy cough pouch
ascot: penne wryly vivid jumbo shock coast ascot
plane: shift jumbo cedar gavel apple plane
crown: shift llama buggy rover crook crowd crown
urban: shift vodka peace mammy lunar urban
snide: chaff jumbo kitty prize exile swine snide
relay: shift jumbo apnea grave cedar relax relay
abide: front shuck payee amaze agile abide
viola: segue fanny drawl alibi lilac viola
rajah: knoll dizzy umbra graft caper harsh rajah
straw: knoll dizzy gruff meter chart strap straw
dilly: chaff jumbo never gypsy ditty dizzy dilly
crash: knoll dizzy fever smart grass brash crash
amass: front dizzy weave clasp quash amass
third: along pubic jiffy write skirt third
trick: along dummy fewer crick brick prick trick
tutor: chaff pixel rowdy gross turbo tumor tutor
woody: chaff slump never bobby toddy goody woody
blurb: chaff dizzy penne groom burst blurb
grief: knoll chart verse riper fried brief grief
disco: relay humph going ovoid widow ditto disco
where: along dizzy burst fever crepe where
sassy: front pixel whack gaudy jazzy mammy savvy sassy
beach: front dizzy lapel amuse kebab beach
sauna: prowl dizzy beget knack human fauna sauna
comic: drank fully sweep thigh mimic comic
clued: front amass bilge whelp level clued
creep: along shift demur wreck crepe creep
caste: humor dizzy apnea weave fable taste caste
graze: shift jumbo apnea cedar large grave graze
snuff: abide wryly humph stunt snuck snuff
frock: spite jumbo rowdy acorn crock frock
gonad: shift queer apply mambo vodka gonad
drunk: chaff pixel buggy strut round drunk
prong: chaff dizzy jumbo evoke snort grown prong
lurid: chaff spoon melee blitz vigil lurid
steel: chaff jumbo grind testy swept steel
halve: front slump wield excel leaky valve halve
buyer: along shift wreck demur upper buyer
vinyl: chaff jumbo steep dryly lying vinyl
utile: chaff spoon dryer bible exile guile utile
smell: chaff tying error level quell swell spell smell
adage: front spice blaze weave quake adage
worry: chaff slump onion evoke bobby dowdy worry
tasty: humor abide fanny wacky gayly jazzy savvy patsy tasty
local: shift wryly melee gland cabal vocal local
trade: knoll spicy queer brave graze frame trade
finch: segue wryly kappa motto civic finch
ashen: prowl dizzy fugue exact kebab haven ashen
modal: shift wryly pluck level banal modal
gaunt: spice wryly doubt vaunt haunt jaunt taunt gaunt
clove: drank shift quell globe elope clove
enact: humor dizzy lapel tweak agate beast exact enact
adorn: shift bulky rover wrong acorn adorn
roast: penne dizzy jumbo flock worth rotor roast
speck: along dizzy butte fewer chess speck
sheik: along dummy refer evict pixie sheik
missy: along queer thick fizzy wispy sissy missy
grunt: chaff pixel muddy stunt brunt grunt
snoop: chaff wryly ditto noose spoon snoop
party: knoll segue chaff mamma daddy jazzy tabby ratty warty party
touch: drank pixel fussy cough vouch touch
mafia: knoll segue chart jazzy vapid maxim mafia
emcee: along dizzy these revue emcee
array: shift jumbo wedge knack papal array
south: drank pixel buggy couch mouth south
vapid: front segue black mamma paddy vapid
jelly: chaff outdo spike never leggy belly jelly
skulk: chaff dizzy penne bosom trust skull skulk
angst: humor bevel paddy ninja stank angst
tubal: spice wharf manga alloy tubal
lower: chaff stern giver purer ember odder joker wooer lower
crest: along dizzy humph fever wreck cress crest
sweat: humor fanny villa agape kebab stead sweat
cyber: along shift prude merry cyber
adore: shift bulky eager recap arena adore
tardy: knoll segue macaw jazzy happy taffy tabby tatty tardy
swami: front gaudy slave shack spasm swami
notch: segue wryly kappa idiom tooth botch notch
groom: chaff pixel bossy trout drown groom
roach: spite fanny brawl chard roach
hitch: along queer skimp vivid fifty witch hitch
young: chaff pixel bosom rowdy young
align: humor sweat daddy aback affix aping align
ready: shift along paper wreak zebra ready
frond: spice jumbo worth ovary drool frond
strap: knoll dizzy umbra waver grass scrap strap
puree: along shift muddy queer rupee puree
realm: shift vodka lapel glean amble mealy realm
venue: chaff wryly onset begin penne venue
swarm: knoll dizzy fever brush strap swarm
offer: junta wryly sperm giver corer odder offer
seven: chaff jumbo dizzy expel tweet never seven
dryer: along first cheer udder dryer
diary: knoll these rumba array fairy diary
dryly: chaff jumbo visit kneel wryly dryly
drank: shift jumbo revel angry prawn crank drank
acrid: knoll segue tatty wharf vicar acrid
heady: front impel sauce kebab heavy heady
theta: knoll dizzy parer stage cheat theta
junto: chaff wryly kiosk doubt outgo junto
pixie: along shuck edify rivet pixie
quoth: drank spice folly buxom outgo quoth
bonus: chaff wryly ditto spook mouse bonus
shalt: frown dizzy kappa usual clash shale shalt
penne: chaff jumbo dizzy knelt never sense penne
amend: shift prowl buggy dance knead amend
datum: knoll beech affix spray guava datum
build: chaff spoon melee wryly guilt quill build
piano: segue tatty llama whack drain piano
shelf: drank jumbo twixt leech shell shelf
lodge: chaff erupt vixen bless jelly lodge
suing: chaff wryly embed spook stunt suing
rearm: shift along paper brake ready rearm
coral: shift gaudy aback ocean local coral
ramen: shift vodka agape relay rarer ramen
worth: spice along doubt motor forty worth
psalm: front dizzy weave glass small psalm
infer: adopt bulky which eerie risen inner infer
overt: chaff slump dizzy brown gorge retro overt
mayor: shift penne blurb crock razor major mayor
ovoid: chaff slump green bobby idiot ovoid
glide: chaff jumbo spent liver exile glide
usage: front dizzy basal swamp quash usage
poise: chaff wryly budge tepee spoke posse poise
randy: shift jumbo lever prank angry randy
chuck: along dizzy queue brush chump chuck
prank: shift jumbo wedge lanky knack prank
fishy: along queer bitty dizzy wispy sissy fishy
tooth: drank pixel jumbo goofy sooth tooth
ether: along dizzy sperm rebut three ether
drove: chaff stern ruler grime probe erode drove
idler: chaff stern buyer wooer giver plier idler
swath: knoll dizzy augur mamma peace shaft stash swath
stint: chaff jumbo eerie dizzy still stink sting stint
while: front slump label cycle exile while
begat: humor fanny stave adept eclat begat
apply: front segue valid plaza amply apply
slang: humor dizzy weave clack blast slang
tarot: spice flown dough ovary arbor tarot
radar: shift along crazy umbra parer radar
credo: shift llama buggy woken prove error credo
aware: shift jumbo never large drape aware
canon: shift queer apply vodka mambo wagon canon
shift: along queer dizzy skimp stiff swift shift
timer: along shuck dryer fewer piper timer
bylaw: front slump level child bylaw
serum: along dizzy ester cress serum
three: along dizzy cress ember puree three
steak: humor fanny plate asset stead steak
iliac: front segue dizzy khaki cavil iliac
shirk: along dummy fewer crisp skirt shirk
blunt: chaff dizzy rupee stunk mount blunt
puppy: along shift deuce murky puppy
penal: shift jumbo wryly gland navel penal
joist: chaff wryly penne doubt vomit joist
bunny: chaff pixel stood murky buggy bunny
shape: front dizzy basal swash shake shave shame shape
beget: chaff slump diode tweet egret beget
wheel: front slump villa excel jewel wheel
adept: humor fanny villa stage tweak adept
stunt: chaff wryly vivid noose skunk stung stunt
stole: chaff deign purer evoke booze smote stole
topaz: segue fanny brawl axiom vodka topaz
chore: junta wryly riper gorge ombre shore chore
fluke: adopt cinch merry swell bulge fluke
afoot: spice jumbo vodka annoy arrow allot afoot
bloat: spice fanny ardor koala gloat bloat
bully: chaff spoon wedge blurt bulky bully
dense: chaff jumbo pixel geese verse sense tense dense
caper: shift along dread rearm waver baker paper caper
sneer: chaff jumbo wryly giver ester sneer
boxer: chaff stern giver purer older joker wooer boxer
jumbo: chaff wryly kiosk mount buxom gumbo jumbo
lunge: chaff dizzy error upset queue bugle lunge
space: front dizzy basal askew shame suave space
avail: front slump liege chili valid avail
short: abide flock swoop stony shout short
slurp: chaff tying brood verse usurp slurp
loyal: shift queer blown polka modal vocal loyal
flirt: segue known dizzy avail climb flirt
pizza: front segue idyll chick maxim pizza
conch: first gaudy level whoop conch
tempo: chaff wryly kiosk gouge detox tempo
droop: chaff tying jumbo sword erode droll droop
plate: humor fanny abide leave scale glaze plate
bible: chaff outdo spiky vigil liner bible
plunk: chaff dizzy worst quell plumb plunk
afoul: spice tatty board among aloof afoul
savoy: penne fruit black mamma daddy gassy savvy savoy
steep: along dizzy chuck fever tweet steep
agile: front slump belch dwell exile agile
stake: humor fanny agape lease state stave stake
dwell: chaff tying slump lover belle dwell
knave: shift jumbo cedar payee glaze awake knave
beard: shift along paper creak rearm weary beard
arose: vying clerk berth power froze erode arose
motif: drank segue jolly tooth vomit motif
smash: front dizzy basal phase quash swash smash
broil: chaff segue rowdy minor orbit broil
glare: shift jumbo apnea ready craze glare
shove: drank fully twixt goose scope shove
baggy: front pixel swash kayak mammy daddy jazzy cabby baggy
mammy: front pixel swash gaudy cabby jazzy mammy
swamp: front dizzy basal shake spasm scamp swamp
along: shift wryly melee pupal black along
rugby: chaff pixel stood gummy buggy rugby
wager: shift jumbo drank paper rarer gayer eager lager wager
quack: front dizzy weave clamp shack aback quack
squat: knoll dizzy verve chaff mamma squat
snaky: humor elect dizzy gypsy assay savvy snaky
debit: along fuzzy steep twice merit debit
mange: shift vodka rebar agape gauze eagle mange
skate: humor fanny agape evade slate state skate
ninth: segue wryly kappa vomit ditch fifth ninth
joust: chaff wryly genie buxom stout joust
tramp: knoll dizzy fever harsh umbra cramp tramp
spurn: chaff dizzy bosom sleet skunk spurn
medal: front spicy bugle wheel medal
micro: segue blank forty droop micro
rebel: chaff stern gorge pried ruler revel rebel
flank: humor dizzy basal leapt clack flank
learn: shift jumbo radar crave weary pearl learn
nadir: segue chaff taboo mamma dairy radii nadir
maple: front dizzy glass cabal halve maple
comfy: drank pixel youth boozy soggy comfy
remit: along shuck dizzy twixt befit merit remit
gruff: knoll tatty vivid sheer crumb gruff
ester: along dizzy humph wreck verse ester
least: humor fanny agile cleat leapt least
mogul: chaff dizzy penne trust jumbo mogul
fetch: along dizzy purer these fetch
cause: front dizzy legal shake masse pause cause
oaken: shift decry gleam awake oaken
aglow: shift queer manly plaza local aglow
meaty: knoll spice tweed berth jetty meaty
gaffe: humor dizzy apnea weave cable taste gaffe
shyly: front amaze buddy gipsy slyly shyly
racer: shift along dread paper waver baker rarer racer
prowl: chaff tying skulk bevel drool prowl
thief: along dummy strip witch thief
stern: chaff jumbo wryly ridge enter stern
poesy: chaff deign otter elbow smoke poesy
rocky: shift llama never group worry rocky
tweet: along dizzy chuck fever steep tweet
waist: humor penne dizzy click stiff twist waist
spire: along dummy theft viper prize spire
grope: chaff stern ruder eerie broke prove grope
havoc: first bulky wedge coach macho havoc
patsy: humor abide fanny wacky gayly jazzy sappy pasty patsy
truly: chaff penne booby dimly slyly truly
forty: spice along doubt motor worth forty
deity: along crumb swept jetty hefty deity
uncle: shift drawl gloom belle cycle uncle
swish: along queer dizzy skimp swift swish
giver: chaff stern purer ember wooer diver liver giver
preen: chaff jumbo dizzy level egret sneer preen
bevel: chaff tying slump dowel revel level bevel
lemur: chaff stern rodeo gripe jerky lemur
draft: knoll segue happy vicar award draft
slope: chaff tying lemur dowel bloke elope slope
annoy: shift pluck weave mambo organ annoy
lingo: chaff queer mossy onion dingo bingo lingo
bleak: front dizzy swash lapel algae bleak
ditty: along queer chick sissy fizzy bitty witty ditty
curly: shift penne kayak woody gummy curvy curry curly
cedar: shift along marry wrack recap cedar
dirge: chaff stern lover pride ridge dirge
grown: chaff slump ditto rover brook wrong grown
horde: junta wryly sperm rover force gorge horde
drool: chaff tying jumbo power dross droll drool
shuck: along dizzy queue truth chump shuck
crypt: along femme birth truss crypt
cumin: float gypsy brink index winch cumin
stock: abide wryly month stout stoop stock
gravy: shift jumbo radar prank craze gravy
locus: drank hippo goofy vowel moult locus
wider: along erupt mercy skier fiber river wider
breed: along shift mercy rupee breed
quite: along seedy rivet ethic quite
chafe: knoll dizzy sweat agape brave chafe
cache: front dizzy sweep blame gauge cache
blimp: chaff outdo genre willy bliss blimp
deign: chaff jumbo silly twixt prize eking deign
fiend: humor tacit spiky bilge widen fiend
logic: drank these fully blimp vigil logic
cheap: front dizzy skull mamma peach cheap
elide: chaff jumbo tying drill plied slide elide
rigid: chaff jumbo steep windy vivid rigid
false: humor tying level apple blaze false
renal: shift jumbo kappa weave cedar relay regal renal
pence: shift llama dryer vogue penne pence
rowdy: chaff slump onion evoke bobby dodgy wordy rowdy
shoot: drank pixel jumbo soggy scoff shoot
blaze: front spice wedge valve amble blaze
envoy: chaff slump ditto woken ebony enjoy envoy
posse: chaff tying bleed swore mouse posse
brief: along shuck piety eerie dried brief
never: chaff jumbo spike greed enter newer never
abort: spice fanny modal arrow agora abort
mouse: chaff tying bleed swore posse mouse
mucky: along shift revue dumpy mucky
sulky: chaff penne rowdy bitty gummy sully sulky
fiery: along shuck remit pried fibre fiery
media: front shuck abbey weave pedal media
trunk: chaff pixel buggy mound skunk trunk
yeast: humor pixel stead waste beast feast yeast
clear: shift jumbo apnea grave relay clear
skunk: chaff wryly vomit undue spunk skunk
scalp: front dizzy melee laugh class scalp
bitty: along queer chick sissy fizzy ditty witty bitty
cider: along erupt fewer skier river cider
koala: shift gaudy brawl leave clank koala
duvet: along spice beefy truer duvet
segue: chaff wryly mound upset guise segue
creme: along shift berry wreck creed crepe creme
super: along dizzy threw freer upper super
grill: chaff jumbo penne dizzy skirt grill
after: knoll dizzy segue crept extra water after
owner: chaff slump jetty greed river wooer owner
ember: along shift ruddy crepe ember
reach: knoll dizzy erupt smear carve reach
nobly: chaff segue ditto woozy poppy lorry jolly nobly
empty: along shuck vivid freer petty empty
speed: along ethic queue weedy breed speed
gipsy: chaff jumbo never dizzy silky wispy tipsy gipsy
recur: along shift murky prude recur
smock: abide wryly stung spoof shock smock
dread: shift along paper craze break dream dread
merge: chaff stern rover prude eerie merge
burst: along dizzy fewer usurp scrub burst
kappa: front dizzy swash value magma kappa
amity: knoll defer sushi pizza tacit amity
shaky: front pixel mucus assay savvy shady shaky
hover: junta wryly sperm force rodeo boxer hover
carol: shift penne buggy award molar carol
snort: chaff pixel rowdy juror gross storm snort
synod: chaff bevel trump going snowy synod
faint: humor swell dizzy antic taint paint faint
haunt: spice wryly doubt vaunt jaunt gaunt taunt haunt
flour: spice hobby adorn growl floor flour
chair: knoll segue tatty chaff champ chard chair
detox: chaff slump vying booze order detox
shrew: along dizzy crept verse surer shrew
tense: chaff jumbo pixel wedge verse sense tense
plied: chaff jumbo tying drill elide plied
quark: shift along cedar parry umbra quark
burly: chaff spoon wedge blitz bulky burly
novel: chaff dizzy jumbo error stone woven novel
waxen: shift jumbo cedar agape navel waxen
stoic: drank fully beget witch topic stoic
jerky: along shift embed wreck perky jerky
blitz: chaff spoon wedge truly limit blitz
beefy: along spice ruder teeth beefy
lyric: segue adapt inbox whiff mimic lyric
hussy: along defer bitty mucky puppy hussy
towel: chaff dizzy jumbo error posse woven towel
quilt: chaff spoon wedge bulky quill quilt
below: chaff tying odder loose elbow below
bingo: chaff slump tweed irony onion bingo
wispy: along queer bitty fizzy picky hippy wimpy wispy
brash: knoll dizzy fever scram grass trash brash
scone: apply threw begun fiend ozone scone
toast: penne wryly chuck affix mamma boast toast
easel: front dizzy humph clack valve label easel
saucy: front pixel mamma baggy daddy jazzy savvy sassy saucy
value: front dizzy glass cabal maple halve value
spice: along dummy beset fresh spike spice
honor: spice jumbo flora rowdy north honor
route: chaff deign elbow poesy mover route
sharp: knoll dizzy fever rumba carat graph sharp
bawdy: front pixel shaky mammy gaudy daddy bawdy
radii: knoll segue chaff tatty maxim rapid radii
skull: chaff dizzy penne bosom trust skulk skull
phony: first llama queue bongo knock phony
issue: along fetch drier equip imbue issue
lager: shift jumbo drank paper waver racer gayer eager lager
swell: chaff tying error level quell smell spell swell
urine: chaff sloop jetty wider grime brine urine
gassy: front pixel mucus awash sassy gassy
trial: segue fanny vodka claim axial trial
flora: spice tatty drank augur moral flora
upper: along shift wreck ember ruder upper
latch: segue drank taboo yacht watch hatch match catch patch latch
wight: drank jumbo pixel sissy fifth tight wight
brick: along teeth dizzy skiff crick prick brick
retry: along spice breed femur jerky retry
holly: drank slump vigil wooly coyly folly jolly holly
decal: front slump helix leggy bezel decal
grass: knoll dizzy umbra waver tract graph grass
shack: front dizzy basal spasm shave shack
dogma: shift queer jazzy aback nomad dogma
mover: chaff stern purer older wooer joker boxer mover
defer: along spice berry meter fever defer
sober: chaff tying melee purer wooer joker boxer sober
optic: drank fully beget smith topic optic
crier: along threw fever buyer riper drier crier
vying: chaff jumbo steep dingy lying vying
nomad: shift queer apply knack banjo woman nomad
flute: drank spicy wheel bugle flume flute
hippo: drank fully sieve mimic tight hippo
shark: penne jumbo tatty affix clash shard shark
drier: along threw fever buyer riper crier drier
obese: chaff tying would spook verso obese
bugle: chaff dizzy spoon ember butte bulge bugle
tawny: humor abide stack fatal tangy tawny
chalk: front slump vigil bylaw ladle chalk
feast: humor dizzy apnea tweak slate beast feast
ruddy: along shift crumb puree ruddy
pedal: front bulky slash gavel decal medal pedal
scarf: knoll dizzy rupee grass smart scarf
cruel: shift amaze boney elder gruel cruel
bleat: humor fanny sepia adage tweak cleat bleat
tidal: humor fanny glass eclat vital tidal
slush: front dizzy aback quell plump slush
semen: chaff wryly outdo binge seven semen
windy: chaff jumbo stilt giver ninny kinky windy
dusty: along riper fussy mushy dusky dusty
sally: front abide whack mamma sappy savvy sassy sally
igloo: chaff queer mossy widow inbox igloo
nerdy: chaff jumbo pixel wrest genre nerdy
jewel: chaff tying slump level rebel jewel
shone: apply medic roger ethos whose shove shone
whale: front slump vigil abled leaky whale
hymen: first pluck adage venom enemy hymen
abuse: front dizzy lapel mecca suave abuse
fugue: drank spicy teeth booze flume fugue
elbow: chaff tying demur spoke vowel elbow
crumb: along dizzy queue shush trump crumb
pansy: humor abide wacky tasty sappy palsy pansy
welsh: front dizzy aback plump wheel welsh
syrup: along fruit surer shrub scrum syrup
terse: along dizzy humph wreck refer serve terse
suave: front dizzy basal shack swamp suave
gamut: knoll dizzy verve chasm magma gamut
swung: chaff pixel muddy trout skunk swung
drake: shift along paper rearm craze brake drake
freed: along spice jetty queer breed freed
afire: knoll erupt sheer ready carve afire
shirt: along dummy piece swift skirt shirt
grout: chaff pixel roomy brown dross trout grout
oddly: chaff segue pinto brook dolly oddly
tithe: along bused empty refit twice tithe
plaid: front segue billy axial claim plaid
dummy: along shift revue mucky jumpy dummy
broom: chaff tying would spore brook broom
blind: chaff segue wimpy joint brink blind
torch: segue dizzy flown abhor morph torch
enemy: chaff outdo prize swell geeky enemy
again: humor sweat cabby pizza affix avail again
tying: chaff jumbo verse idyll pinky tying
pesky: along chide refer jetty pesky
alter: vying jumbo chaff stead extra water alter
gazer: shift jumbo drank paper waver layer rarer eager gazer
noble: chaff dizzy queer tempo glove noble
ethos: drank fully joist smote ethos
bride: along shuck jetty river prize bribe bride
extol: chaff deign purer smoke elbow extol
decor: shift llama buggy prove cower decor
hobby: drank pixel mucus foggy woozy bobby hobby
beast: humor fanny villa askew stead tease beast
idiom: chaff wryly segue pivot onion idiom
utter: along dizzy brush curve femur upper utter
these: along dizzy purer eject teeth theme these
sixth: along queer timid witty fifth sixth
alarm: shift vodka eagle lunar brawl alarm
erase: knoll dizzy threw recap brave frame erase
elegy: chaff jumbo spite dryer newly elegy
spunk: chaff wryly vomit undue skunk spunk
piper: along threw fever buyer skier cider riper piper
scaly: front abide macaw chalk scalp scaly
scold: junta grimy evoke whoop floss scold
hefty: along spice embed query jetty hefty
chick: along queer dizzy shift which chick
sooty: chaff pixel jumbo worry dodgy sooty
canal: shift jumbo wryly plank angel naval canal
whiny: segue draft block minim whiny
slash: front dizzy melee pupal black glass slash
quake: front dizzy lapel chase weave quake
joint: chaff slump wedge kinky intro toxin joint
swept: along dizzy chute wrest sweet swept
prude: along shift mercy udder prude
heavy: front impel sauce kebab heady heavy
wield: chaff jumbo zesty eking pixie rider wield
femme: along dizzy purer chest femme
lasso: penne dizzy chaff about moral salvo lasso
maize: front shuck beady algae waive maize
shale: front dizzy kappa glass small scale shale
screw: along dizzy theft verse surer screw
spree: along dizzy theft surer scree spree
smoky: chaff pixel outdo gross snowy smoky
whiff: along ester jumpy vivid chick whiff
scent: humor dizzy gaffe level speck scent
glade: front spice value whale blame glaze glade
spent: chaff jumbo dizzy reset slept spent
prism: along beech dizzy skiff wrist prism
stoke: chaff wryly minus stoop stove stoke
riper: along threw fever buyer skier cider piper riper
orbit: chaff slump evoke dowdy rigor intro orbit
cocoa: shift gaudy aback clear comma cocoa
guilt: chaff spoon melee wryly build quill guilt
humus: along dizzy tepee crumb humus
shush: along dizzy tepee shrub shuck shush
table: humor dizzy apnea flake valve eagle cable table
smirk: along beech dizzy swift skimp smirk
wrong: chaff slump ditto rover brook grown wrong
noisy: chaff truer poppy jolly moody soggy bossy noisy
alert: vying jumbo chaff kappa straw alter alert
shiny: float creme buggy pinky whiny shiny
elate: humor fanny sepia awake glade blaze elate
resin: chaff jumbo idyll tripe river resin
whole: drank slump vigil lofty cello whole
hunch: first llama wedge booby chunk punch hunch
pixel: chaff jumbo wedge stein river pixel
polar: shift gaudy wrack rebar molar polar
hotel: drank slump icily level bowel hotel
sword: chaff pixel jumbo rotor gross sworn sword
cleat: humor fanny sepia glade bleat cleat
mango: shift queer apply vodka bacon mango
rumba: shift along wacky bread umbra rumba
puffy: along ester vivid chump puppy puffy
filly: drank jumbo steep civil willy hilly filly
billy: chaff outdo never gypsy milky willy billy
leash: front dizzy kappa usual class lease leash
clout: drank hippo jolly globe floss clout
dance: shift jumbo wreak agape ladle dance
ovate: pluck dizzy eaten great heath state abate ovate
facet: humor dizzy slave kebab annex facet
chili: front slump level gayly child chili
paint: humor swell dizzy antic faint taint paint
liner: chaff jumbo wedge exist piper river liner
curio: penne tatty floss rough occur curio
salty: humor abide fanny wacky jazzy sappy savvy sassy sally salty
audio: penne wryly scoff buxom outgo audio
snake: humor dizzy lapel abate weave snake
fable: humor tying level bless cable fable
cloak: shift wryly melee plunk black cloak
navel: shift jumbo cedar agape waxen navel
spurt: along dizzy queue shuck stump spurt
pesto: chaff wryly minus speed posse pesto
balmy: front segue which kayak daddy jazzy mammy balmy
flash: penne jumbo tatty crash swash flash
unwed: chaff stilt booze penny queen under unwed
early: shift jumbo apnea grave relax early
churn: spite blood magma hunch chunk churn
weedy: along shift jumpy berry weedy
stump: along dizzy queue trust stuck stuff stump
lease: front dizzy humph basal slack lease
witty: along queer chick sissy fizzy bitty ditty witty
wimpy: along queer thick sissy fizzy biddy wimpy
spoof: drank ethic gumbo loopy swoop spoof
saner: hobby medic glare paper eater waver rarer safer saner
blend: chaff spite rover geeky quell blend
salsa: front dizzy humph level class salsa
thick: along defer jumpy swish chick thick
warty: knoll segue chaff vapid mammy jazzy tabby ratty warty
manic: segue wryly vodka chaff tacit panic manic
blare: shift vodka repay eager craze aware blare
squib: along defer picky swish squib
spoon: chaff wryly ditto noose snoop spoon
probe: chaff stern ruder jerky grime prove probe
crepe: along shift demur wreck creep crepe
knack: shift jumbo wedge lanky crank knack
force: junta wryly sperm rover horde gorge force
debut: along jiffy steep chute rebut debut
order: chaff stern giver bluer mower odder order
haste: knoll dizzy queer agape masse baste waste taste caste haste
teeth: along dizzy purer eject these teeth
agent: humor dizzy lapel snake vegan agent
widen: chaff jumbo stilt vivid dizzy rider widen
icily: front slump bevel willy gaily icily
slice: front bulky jewel apple slime slide slice
ingot: chaff slump eerie bingo going ingot
clash: front dizzy melee pupal slack class clash
juror: chaff pixel rowdy brook tumor juror
blood: chaff segue pinto woozy brook bloom blood
abode: shift pluck waxen beard adobe abode
throw: spice along outdo forty throb throw
unity: chaff prowl embed stung nutty unity
pivot: chaff wryly queue stink timid bigot pivot
slept: chaff jumbo wedge viper spelt slept
troop: chaff dizzy jumbo knoll gross prove troop
spare: knoll dizzy threw rebar grave scare spare
sewer: along dizzy crept rebus serve sewer
parse: knoll dizzy beech fugue state masse parse
morph: segue dizzy flock abhor north morph
cacti: humor penne dizzy flick attic cacti
tacky: humor abide fanny gassy jazzy tatty tally tacky
spool: chaff dizzy jumbo rover swoop spook spoon spool
demon: chaff wryly kiosk outdo modem demon
moody: chaff pixel burst goody woody moody
annex: shift jumbo cedar plane waxen annex
begin: chaff slump video inert eking genie begin
fuzzy: along ester chick dumpy fuzzy
patch: knoll dizzy augur theta stash batch watch catch hatch match patch
water: knoll dizzy segue paper rarer tamer cater hater water
lumpy: chaff stork wedge bunny puppy jumpy lumpy
admin: segue chaff tatty briar pizza avoid admin
omega: shift bulky waxen recap evade omega
limit: chaff spoon buggy delve twirl limit
tabby: humor aside fanny jazzy tacky tally tatty tabby
macho: first bulky wedge coach havoc macho
aisle: front gaudy mecca bleak whale apple aisle
skiff: along queer dizzy swish stick skimp skiff
basis: front apply whack mamma gauge basis
plank: shift jumbo wedge kayak crank plank
verge: chaff stern rower bride purge merge verge
botch: drank pixel foggy joust tooth botch
crawl: shift jumbo radar grave prank crazy crawl
lousy: chaff penne ditto roomy bobby golly lousy
slain: humor apply elate flack gland slain
cubic: along ester dizzy which pubic cubic
raise: knoll erupt weary gamer carve raise
wrack: shift along radar zebra cramp wrack
guide: chaff wryly spoon debit midge guide
foist: drank bulge spicy moist joist hoist foist
cameo: shift bulky wedge annex racer cameo
under: chaff stilt roomy verge upper udder under
actor: segue fanny llama triad abort actor
revue: along shift murky upper crude revue
fraud: knoll spicy beget mamma dwarf fraud
harpy: knoll segue tacit mamma jazzy paddy happy harpy
scoop: drank fully tight posse swoop scoop
climb: front segue dizzy cavil chili click climb
refer: along dizzy shrub creep meter fever refer
olden: chaff erupt binge semen woken olden
clerk: shift jumbo agape never wreck clerk
debar: shift along wacky rumba beard debar
tally: humor abide fanny wacky gassy jazzy tatty tally
ethic: along bused retry theft ethic
cairn: segue float khaki pizza nadir rainy cairn
tulle: chaff deign rover swept butte tulle
ghoul: drank spice bully fluff mogul ghoul
hilly: front slump bevel gayly willy dilly hilly
crude: along shift murky upper revue crude
apart: knoll dizzy gruff meter straw chart apart
scale: front dizzy humph basal class scale
older: chaff stern giver purer ember wooer odder older
plain: humor sweat badly flack plaza plain
sperm: along dizzy chuck reset press sperm
briny: chaff slump tweed onion brink bring briny
abbot: spice flown dough mambo arbor abbot
rerun: chaff dizzy swell prove ember rerun
quest: along chide empty truer fetus quest
crisp: along teeth jiffy druid crick crimp crisp
bound: chaff wryly kiosk vogue mount pound bound
befit: along shuck dizzy twixt merit befit
drawn: shift jumbo revel angry crank prawn drawn
suite: along beefy cider exist smite spite suite
itchy: along defer skimp cubic witch itchy
cheer: along dizzy verse ember queer freer cheer
bagel: front slump wield leave hazel bagel
guess: chaff wryly onion beget judge guess
broad: shift penne gawky comma arbor bravo broad
axiom: segue fanny brawl pizza admit axiom
chard: knoll segue tatty chaff champ chair chard
caput: knoll dizzy verve swash mamma caput
leant: humor dizzy basal clack leave leapt leant
harsh: knoll dizzy umbra graft caper rajah harsh
curse: along dizzy theft sewer purse curse
proud: chaff vying melee worst brook proud
swing: chaff jumbo eerie dizzy skill stint swing
opine: chaff wryly unmet binge noise ovine opine
taste: humor dizzy apnea cleat stave waste baste taste
lupus: chaff tying world bezel plump lupus
gumbo: chaff wryly kiosk mount buxom jumbo gumbo
miner: chaff outdo wryly giver riper miser miner
green: chaff jumbo spike level egret greed green
chasm: front dizzy basal usage scamp chasm
lipid: chaff jumbo never twist dilly lipid
topic: drank fully beget witch stoic toxic topic
armor: shift gaudy weave borax acorn armor
brush: along dizzy fewer crump truth brush
crane: shift jumbo radar gravy wrack craze crane
mural: shift vodka apply lager brawl rural mural
abled: front slump vigil whale delay abled
habit: knoll segue jiffy rapid maxim tacit habit
bossy: chaff pixel outdo snowy mossy bossy
maker: shift along recap brave maker
dusky: along riper fussy mushy dusty dusky
dizzy: along queer thick sissy wimpy jiffy biddy dizzy
lithe: drank jumbo spicy filet title lithe
brook: chaff tying would spore broom brook
jazzy: front pixel swash gaudy cabby mammy jazzy
fifty: along queer chick midst bitty fifty
sense: chaff jumbo dizzy knelt never penne sense
giant: humor bevel dandy knack spawn giant
surly: chaff penne vivid booby gusty sully surly
legal: front slump cycle bezel devil legal
fatal: humor dizzy glass lapel naval cabal fatal
flunk: spice wrath mogul dully bluff flunk
began: shift vodka rarer agape gleam began
prune: chaff dizzy stork lemur puree prune
small: front dizzy kappa glass scale shall small
slant: humor dizzy weave clang flank plant slant
scoff: drank pixel jumbo soggy shoot scoff
torus: chaff pixel known bosom soggy joust torus
ninny: chaff jumbo stilt giver dizzy kinky ninny
covey: drank shift jumbo polyp gooey covey
viper: along threw freed skier riper piper viper
taken: humor dizzy slave pecan waxen eaten taken
moral: shift gaudy weave polka local zonal moral
vogue: chaff wryly kiosk tempo dozen gouge vogue
owing: chaff slump eerie dizzy ingot going owing
token: chaff slump rigor booby woven dozen token
entry: chaff jumbo spike dwell never entry
booth: drank pixel soggy mouth tooth booth
voter: chaff slump onion erode joker roger boxer tower voter
chide: along fuzzy sweep berth chime chide
elfin: humor tatty pence index eking elfin
ebony: chaff slump vivid tweet gorge enjoy ebony
neigh: float bused piece eking reign neigh
minim: chaff wryly stood begin unzip minim
melon: chaff dizzy queer stone venom lemon melon
kneed: chaff jumbo spite renew kneel kneed
decoy: shift bulge wreak money epoxy decoy
voila: segue fanny drawl alpha villa voila
ankle: shift jumbo cedar panel angle ankle
arrow: shift gaudy llama ocean arbor arrow
mushy: along defer thick pushy bushy mushy
tribe: along shuck dizzy remit tripe trite tribe
cease: front dizzy basal askew suave phase cease
eager: shift jumbo drank paper waver layer rarer gazer eager
birth: along dummy tepee shift witch birth
graph: knoll dizzy umbra waver tract grass graph
odder: chaff stern giver purer ember wooer older odder
terra: knoll dizzy gruff paper scare avert extra terra
weird: along shuck empty fixer bride weird
tried: along shuck eerie river fried pried dried tried
clack: front dizzy melee laugh scalp black clack
color: shift penne buggy macaw crock color
rough: spice flown mambo tough dough rough
weigh: front amass pubic dizzy exile weigh
uncut: abide floor pygmy skunk hunch uncut
ladle: front slump vigil bylaw chalk ladle
strip: along beech muddy wrist strip
craft: knoll dizzy umbra waver scrap tract craft
minus: chaff prowl kneed nutty using minus
dicey: along brush jiffy kitty wimpy dizzy dicey
titan: humor gypsy bleed faint antic titan
lucid: front amass glyph bezel livid lucid
vicar: knoll segue tatty braid circa vicar
dress: along ethic berry upper dress
ditch: along queer skimp fifty witch hitch ditch
gypsy: chaff jumbo drink tweet slyly gypsy
pasta: humor jiffy wedge knack splat pasta
taffy: humor abide snack jazzy tatty tally taffy
flame: vying outdo brawl clash plaza flake flame
swoop: chaff dizzy jumbo rover stool spoon swoop
aloof: spice tatty board among afoul aloof
sight: drank jumbo pixel fight tight wight sight
broke: chaff stern ruder grime probe broke
teary: knoll spice fewer rearm beard heart teary
chart: knoll dizzy gruff meter strap chart
sixty: along queer chick vivid wimpy fifty bitty sixty
wordy: chaff slump onion evoke bobby dodgy rowdy wordy
sheer: along dizzy puree fewer ether cheer sheer
leper: chaff stern giver wooer ruler elder leper
nosey: chaff erupt binge demon novel nosey
bulge: chaff dizzy spoon revel exult bulge
savor: penne dizzy chart augur labor major favor savor
clamp: front dizzy segue cabal clack clamp
funky: spice llama toddy buggy hurry fuzzy funny funky
foamy: spice outdo knoll worry hobby foggy foamy
toxic: drank fully beget smith optic toxic
brand: shift carol grave prawn drank brand
plumb: chaff tying world level slump plumb
dingy: chaff jumbo stilt viper ninny kinky windy dingy
butte: along dizzy steep recut butte
drill: chaff jumbo tying spire krill drill
tripe: along shuck dizzy remit write tribe tripe
bicep: along these edify river bicep
tenor: chaff slump vivid broke rower tenor
krill: chaff jumbo tying spire drill krill
worse: chaff tying bleed spore rouse worse
drama: shift along jazzy rebar wrack drama
hyena: first jumbo lapel weave knead hyena
think: segue wryly mamma ovoid fifth thick think
ratio: segue chaff apply vodka manor ratio
cobra: shift gaudy leave apron croak cobra
basil: front pluck leave sadly basal basil
scrum: along dizzy fewer spurt shrub scrum
bused: along chime tweet purer bused
phone: first gaudy cello women ozone phone
court: abide fully thump stuck count court
camel: front dizzy glass apple equal label camel
proof: segue tacit wooly broom droop proof
heard: knoll first queer grave rearm weary beard heard
angel: shift jumbo wryly plank canal angel
petal: humor fanny glass villa decal petal
pouty: chaff wring seedy jolly boozy poppy pouty
throb: spice flown dodgy jumbo arbor throb
maybe: front spice whale gauge maybe
fetal: humor dizzy apnea taste eclat fetal
sprig: chaff jumbo tweed sissy skill sprig
spine: chaff jumbo dryer knelt genie swine spine
shout: drank pixel buggy joust stout scout shout
cadet: humor vying skate bleat facet cadet
macro: shift bulky rover drown cargo macro
dodgy: chaff slump never bitty goody dodgy
satyr: knoll beech vivid tramp warty satyr
rarer: shift along dread paper waver baker racer rarer
binge: chaff slump error index twine genie binge
trend: chaff jumbo spike leggy exert trend
nutty: chaff pixel booby gummy ruddy sunny nutty
leapt: humor fanny aside cleat exalt leapt
amiss: front bulge daddy whack pizza amiss
split: chaff jumbo green sixty stilt split
myrrh: along speed fritz curry myrrh
width: along queer stick bitty fifth width
sonar: bulge dizzy chart aroma favor sonar
tower: chaff slump onion erode joker rover boxer tower
baron: shift pluck wedge roomy arbor baron
fever: along dizzy shrub creep refer fewer fever
waver: shift along recap brake waver
spark: bulge cinch jazzy ardor swarm stark spark
belie: chaff outdo sperm leggy bezel belle belie
sloop: chaff tying jumbo worse spook sloop
expel: chaff tying rover sleek jewel expel
smote: chaff wryly deign obese spoke stove smote
baler: shift vodka agape renal early baler
above: shift gaudy llama recap annex awoke above
north: spice jumbo flora rowdy honor north
wafer: knoll dizzy segue paper cater rarer waver wafer
scant: humor dizzy weave clasp stack scant
frill: segue known ditty blimp axial chill frill
awash: front dizzy usage clasp smash awash
snack: humor dizzy tepee aback flack knack snack
scowl: drank hippo buxom goofy stove scowl
frail: segue tatty mocha prank brawl frail
drift: along beech puppy smirk fritz drift
limbo: chaff segue toddy known primo limbo
fence: humor tatty blend vixen sense pence fence
motel: chaff dizzy queue woven sober golem motel
ounce: shift llama dryer evoke gouge ounce
wreak: shift along paper craze bread wreak
revel: chaff stern gorge pried bluer revel
talon: spice jumbo rowdy offal along talon
prior: chaff segue rowdy troll primo prior
knelt: chaff jumbo wedge liver spelt knelt
cello: drank slump vigil lefty below hello cello
flake: humor tying level scale blaze flake
debug: chaff wryly spike demon debut debug
anode: shift pluck jazzy dream evade abode anode
crime: along fetus dryer prize bribe crime
salve: front dizzy humph black gavel valve salve
scout: drank pixel buggy south stout scout
imbue: along depth sieve juice imbue
pinky: chaff jumbo stilt giver ninny windy kinky pinky
stave: humor fanny agape lease skate stave
vague: front dizzy swash kappa label gauge vague
chock: first gaudy emcee block knock chock
fight: drank jumbo pixel sissy witch tight fight
video: chaff slump beget drier index video
stone: chaff wryly budge spike smote stove stone
teach: knoll dizzy queer masse peach beach teach
cleft: drank jumbo zesty lithe elect cleft
frost: abide humor wrong crock proxy troll frost
prawn: shift jumbo radar glare crank prawn
booty: chaff slump never dizzy bobby booty
twist: along defer cubic wispy swish twist
apnea: shift jumbo cedar knave waxen apnea
stiff: along queer dizzy swish skimp stiff
plaza: front segue which badly llama plaza
ledge: chaff jumbo riper weedy dense ledge
tweak: humor fanny sepia adage bleat tweak
board: shift penne gawky rural aroma board
grant: spice fully karma ardor wrath grant
medic: along fuzzy whisk river debit medic
bacon: shift queer apply vodka mango bacon
cable: front slump vigil jelly whale cable
brawl: shift vodka apply lager rural crawl brawl
slunk: chaff dizzy ester snoop swung skunk slunk
raspy: knoll abide chaff tatty mammy jazzy savvy gassy raspy
forum: spice along throb wordy forum
drone: chaff slump jetty river gorge broke erode drone
women: chaff dizzy segue extol rower woken woven women
mucus: along dizzy tepee brush mucus
boast: penne wryly chuck affix mamma toast boast
toddy: chaff slump never bobby goody dowdy toddy
coven: shift llama judge epoxy rover woven coven
tumor: chaff pixel rowdy gross turbo tutor tumor
truer: along dizzy sperm revue utter tuber truer
wrath: knoll dizzy umbra strap eater craft wrath
stall: humor fanny aback plaid lease stall
steam: knoll dizzy parer acute feast steam
axial: front slump liege idyll cavil axial
purer: along shift wreck ember udder purer
daily: front slump level chalk gayly badly daily
trail: segue fanny vodka chart tramp trawl trail
niche: float bused grime piece niche
mealy: front shuck pixel elegy jelly mealy
juice: along depth sieve imbue juice
nylon: chaff segue ditto prowl nobly nylon
plump: chaff tying world bezel lupus plump
merry: along shift wreck upper verve derby merry
flail: humor penne dizzy waist affix flail
papal: front dizzy glass valve caulk papal
wheat: knoll dizzy parer acute begat sweat wheat
berry: along shift wreck udder verve merry berry
cower: shift llama buggy never joker wooer power rower cower
erect: along dizzy shrub freer crepe erect
brute: along dizzy sperm threw rebut brute
leggy: chaff jumbo spike enter dwell leggy
snipe: chaff jumbo dryer stein singe spine snipe
sinew: chaff jumbo elite rider given piney sinew
skier: along erupt rhyme defer wiser skier
penny: chaff jumbo giver style needy penny
jumpy: along shift revue mucky dumpy jumpy
rally: shift jumbo wedge prank larva rally
umbra: shift along wacky bread rumba umbra
scary: knoll abide rajah grass smart scarf scary
modem: chaff tying lupus evoke rower modem
gross: chaff pixel rowdy juror storm gross
avian: humor slate caddy ninja aping avian
greed: chaff jumbo spike never egret greed
satin: humor bevel pinky swing stain satin
tonic: segue wryly kappa booth motif toxin tonic
parka: shift along cedar quark karma parka
sniff: humor tacit dizzy spike sling sniff
livid: chaff jumbo green twist idyll lipid livid
stark: penne jumbo which altar tardy graft stark
trump: along dizzy fewer burst truth truck trump
giddy: chaff jumbo never spill kitty dizzy giddy
reuse: along dizzy crept fewer verve reuse
taboo: spice flown dodgy humor abbot taboo
avoid: segue fanny brawl comma adopt avoid
quote: chaff wryly deign steep butte quote
devil: chaff jumbo spent wider elide devil
liken: chaff jumbo wedge spent vixen linen liken
gloss: chaff dizzy jumbo rover known stool gloss
gayer: shift jumbo drank paper waver racer eager gazer gayer
beret: along dizzy humph creek fewer reset beret
noise: chaff wryly unmet binge ovine noise
gland: shift jumbo wryly papal leave clack gland
dealt: humor fanny aback elate leapt dealt
sling: chaff jumbo tweed sissy spill slink sling
rumor: chaff pixel bossy wrong tutor juror rumor
opera: shift gaudy wrack renal amber opera
thigh: drank jumbo swell itchy fifth thigh
tonga: spice fully baron among gonad tonga
flare: vying jumbo steep cache drake aware flare
wound: chaff pixel buggy mount sound round wound
white: along bused retry eject white
bulky: chaff spoon wedge blitz burly bulky
etude: along spicy refer queue etude
horse: junta wryly riper verve force gorge horde horse
circa: knoll segue tatty wharf briar acrid circa
paddy: front segue which kayak mammy badly daddy paddy
inbox: chaff slump wedge kinky joint inbox
fizzy: along queer thick sissy wimpy biddy jiffy fizzy
grain: hobby slump radar avert crack grain
exert: along dizzy shrub fewer crepe exert
surge: chaff dizzy knoll upset rebus surge
gleam: front dizzy swash apple bagel gleam
belle: chaff tying slump lover dwell belle
salvo: penne dizzy chaff about moral lasso salvo
crush: along dizzy fewer strut usurp brush crush
fruit: along speed thick bitty fruit
sappy: front abide caulk mamma jazzy savvy sassy sappy
taker: vying jumbo chaff salad paper rarer eater taker
tract: knoll dizzy umbra waver strap craft tract
ovine: chaff slump jetty error dodge ozone ovine
spiky: along defer thumb sissy spicy spiky
frank: spice tatty augur moral dwarf frank
reedy: along shift purer wreck every reedy
filth: drank jumbo spicy vigil title filth
spasm: front dizzy basal shake scamp spasm
heave: front dizzy sauce apple weave heave
mambo: shift queer apply vodka wagon cacao mambo
right: knoll amass tepid bitty wight fight right
clank: shift jumbo wedge kappa crack clank
trust: along dizzy fewer crump brush truss trust
lumen: chaff dizzy error swept belle lumen
borne: chaff slump jetty wider grove borne
spook: chaff tying jumbo worse sloop spook
sauce: front dizzy bleak weave gauge pause sauce
amber: shift knoll repay craze wager amber
lathe: frown dizzy glass caulk valet latte lathe
carat: knoll dizzy fever grasp rumba carat
corer: shift llama buggy never wooer joker corer
dirty: along beech skimp fifty witty dirty
slyly: chaff jumbo drink tweet gypsy slyly
affix: humor penne dizzy waist flail affix
alloy: shift queer knack modal aglow alloy
taint: humor swell dizzy antic faint paint taint
sheep: along dizzy mucus steer sweep sheep
kinky: chaff jumbo stilt giver ninny windy pinky kinky
wooly: chaff segue point bobby rowdy woozy wooly
mauve: front dizzy sweep beach equal gauge mauve
flung: spice robot dully awful fluff flunk flung
yacht: knoll queer swamp tibia hatch yacht
fried: along threw rupee miser cried dried fried
quail: front beech slimy vigil pupil quail
brunt: chaff pixel muddy stunt grunt brunt
grimy: chaff outdo sweep krill briny grimy
curvy: along shift weedy mucky curry curvy
cagey: front build swash kappa jazzy mammy cagey
rinse: chaff jumbo wryly exert viper dirge rinse
deuce: along missy theft rupee deuce
state: humor fanny agape lease stave stake state
grasp: knoll dizzy umbra waver trash crass grasp
milky: chaff outdo never gypsy billy milky
bison: chaff wryly evoke junto going inbox bison
graft: knoll dizzy umbra waver strap tract graft
sandy: humor bevel kappa tangy nanny dandy candy sandy
baste: humor dizzy apnea cleat stave waste taste baste
flask: humor tying basal scalp lease flask
hedge: front spice amaze bugle wedge hedge
girly: chaff jumbo steep dizzy ninny willy girly
swash: front dizzy basal phase quash smash swash
boney: chaff slump ditto evoke roger boney
coupe: drank jiffy these vogue boule coupe
endow: chaff slump jetty rover oxide endow
abhor: spice flown gourd mayor arbor abhor
welch: front slump vigil ladle belch welch
blade: front spice value whale glaze blame blade
tight: drank jumbo pixel sissy fifth wight tight
geese: chaff jumbo pixel teddy verse sense geese
miser: along erupt fewer diver riser miser
mirth: along puffy beset hitch width mirth
cloud: shift wryly melee along block cloud
cabal: front slump hilly bevel cabal
leech: front slump villa bezel ledge leech
close: drank hippo jolly flout globe clove close
tenth: prowl dizzy amass fugue eject tenth
pecan: shift jumbo gawky evade arena penal pecan
droit: chaff segue billy idiom ovoid droit
grail: penne jumbo tatty chaff award grass grail
clone: shift wryly llama blood glove elope clone
guise: chaff wryly mound queue butte guise
ralph: segue dizzy abbot frank march rajah ralph
tango: spice wryly mouth afoot tango
biddy: along queer thick sissy fizzy wimpy biddy
smith: along queer dizzy stick swift smith
mower: chaff stern giver purer older joker boxer wooer mower
payee: front medic shake valve gauge payee
serif: along dummy exert prize riser serif
drape: shift along wacky zebra dread drape
fifth: along queer stick bitty width fifth
spank: humor abide tasty class spawn spank
glaze: front spice value whale blame glade glaze
allot: spice fanny broad koala aglow allot
truck: along dizzy fewer brush trump truck
kayak: front segue claim paddy kayak
virus: along beech dusky spurt virus
testy: along chide refer setup zesty testy
tepee: along dizzy beech femme verse tepee
fully: drank spice booth gummy fuzzy fully
zonal: shift wryly melee plank annul canal zonal
metro: chaff dizzy bulge swept otter retro metro
curry: along shift weedy mucky curvy curry
grand: shift jumbo revel prawn drank grand
banjo: shift queer apply knack nomad wagon banjo
axion: segue chaff tatty polka ardor axiom axion
bezel: chaff tying slump level jewel rebel bezel
occur: shift llama wedge poppy brook occur
chain: segue tatty vodka brawl champ chaff chain
nasal: humor dizzy flack lapel naval natal nasal
gooey: chaff slump ditto worry booby gooey
filer: adopt shuck eerie miner giver fiber fixer filer
brace: shift along paper bread brake brave brace
allay: front segue vivid whack mammy apply allay
pubic: along ester dizzy chick pubic
raven: shift jumbo drawl agree paper raven
plead: front bulky chill lease gleam plead
gnash: prowl dizzy queue aback staff gnash
flaky: humor stilt lapel bland clack flaky
munch: first apply wedge chunk hunch bunch munch
dully: chaff spoon egret vivid buddy dummy dully
eking: chaff jumbo dryer swept genie eking
thing: prowl amass dizzy quick feign thing
slink: chaff jumbo tweed sissy spill sling slink
hurry: along fruit queer murky curvy hurry
theft: along dizzy purer check these theft
shorn: abide flock roomy gross sport sworn shorn
pygmy: chaff outdo newer spill pygmy
ranch: spite fully agora wrack march ranch
wring: chaff jumbo silly tripe drink wring
lemon: chaff dizzy queer stone venom melon lemon
shore: junta wryly rider verse score spore shore
mamma: front dizzy swash pupal mecca magma mamma
froze: junta pixel mercy where broke grove froze
newer: chaff jumbo spike greed enter never newer
style: chaff jumbo grind tweet zesty style
moose: chaff tying bleed worse posse mouse moose
antic: humor gypsy bleed faint titan antic
drown: chaff slump kitty rover wrong brown drown
vegan: shift jumbo kappa crazy annex glean vegan
chess: along dizzy purer femme check chest chess
guppy: chaff knoll verse bitty dumpy puppy guppy
union: chaff wryly smoke dingo joint onion union
lever: chaff stern purer mower idler lever
lorry: chaff segue point woody jolly lobby lorry
image: front shuck bawdy pizza avail image
cabby: front pixel swash gaudy jazzy mammy cabby
druid: along teeth skimp fizzy cubic druid
exact: humor fanny sepia bleak agate exact
truth: along dizzy fewer burst trump truck truth
dopey: chaff stilt queue rover women gooey dopey
spear: knoll dizzy threw revue press sperm spear
cried: along threw rupee brief drier cried
chime: along bused jetty piece crime chime
crony: shift llama wedge croup crock crony
stunk: chaff wryly vivid tepee boost stung stunk
timid: along queer whisk fizzy civic timid
batch: knoll dizzy augur theta stash watch hatch match catch patch batch
gauge: front dizzy swash kappa label vague gauge
rotor: chaff slump evoke going rowdy robot rotor
crack: shift along radar brave cramp crazy crack
curve: along shift ember decry wreck curve
latte: humor dizzy apnea exact tweak baste latte
witch: along queer skimp vivid fifty hitch witch
bunch: first llama wedge chock hunch punch bunch
repel: chaff stern gorge dried bluer revel repel
anvil: humor sweat cabby pizza affix again anvil
soapy: bulge faint wrack smash soapy
meter: along dizzy shrub creep fever meter
broth: spice fully radar wrong brook broth
madly: front segue which kayak jazzy dally badly madly
dried: along threw rupee brief crier dried
scene: humor gavel edify speck scent scene
known: chaff slump egret vivid boozy known
magma: front dizzy swash value kappa gamma magma
roost: chaff pixel jumbo wrong story roost
woman: shift gaudy leave arbor comma woman
thong: spice jumbo ardor folly known thong
punch: first llama wedge booby chunk hunch punch
pasty: humor abide fanny wacky gayly jazzy sappy patsy pasty
downy: chaff slump retro boozy dodgy downy
knead: shift jumbo rarer agape decal knead
whirl: segue booby panic frill twirl whirl
rapid: knoll segue chaff tatty mamma radii rabid rapid
clang: shift jumbo wryly pedal clack clang
anger: shift jumbo clerk verge gazer anger
drive: along shuck fewer prize bribe trite drive
goofy: drank pixel jumbo shoot woozy goofy
email: front gaudy swash aback leave email
music: along defer hippy twist squib music
stuff: along dizzy queue trust stump stuck stuff
bleep: chaff tying rover jewel sleek bleed bleep
rider: along erupt mercy skier fiber diver wider rider
mecca: front dizzy swash pupal magma mecca
folio: drank slump level chili igloo folio
setup: along chide refer petty setup
verso: chaff tying quell embed swore verso
quash: front dizzy basal phase smash quash
fauna: spice drawl tatty mambo fauna
gummy: chaff pixel stood bunny murky gummy
happy: front segue claim kayak daddy jazzy happy
newly: chaff jumbo spite dryer geeky newly
fussy: along riper duchy mummy fuzzy fussy
relic: adopt bunny fresh giver eerie relic
guava: front dizzy small whack agape guava
ratty: knoll segue chaff vapid mammy tatty batty ratty
fudge: knoll tacit brush jumpy queue fudge
femur: along dizzy brush curve upper femur
chirp: along stuff biddy chime chick chirp
forte: apply cinch jumbo gross overt tower forte
alibi: front segue dizzy chill blimp alibi
whine: float medic piney urine shine whine
petty: along shuck vivid femme berry jetty petty
golly: chaff queer point bosom lowly dolly jolly golly
plait: humor fanny leave glass black plaza plaid plait
fleck: humor naive jetty swell bleed fleck
felon: swath dizzy jumbo corer elope felon
gourd: chaff pixel known motto soggy gourd
brown: chaff slump ditty woven known grown brown
thrum: along dizzy sweet hutch thump thrum
ficus: along tweed jumpy brush ficus
stash: knoll dizzy augur cache swash smash stash
decry: along shift jumpy weedy derby decry
wiser: along erupt mercy diver fiber riser wiser
junta: spice wharf mammy tubal quota junta
visor: chaff penne buggy twixt solid kiosk visor
daunt: spice wryly taboo vaunt haunt jaunt gaunt daunt
scree: along dizzy humph tweet sever scree
impel: chaff outdo jerky exile libel impel
await: humor fanny clack stave adapt await
press: along dizzy chuck reset sperm press
whose: drank fully spice goose those whose
turbo: chaff pixel rowdy gross tumor turbo
stoop: chaff wryly minus beset stood stoop
speak: front dizzy beach mauve askew speak
mangy: shift vodka peace jazzy balmy marry mangy
eying: chaff jumbo tepid liver swine eking eying
inlet: chaff jumbo spiky given index inter inlet
crone: shift llama buggy wooer erode prove crone
pulse: chaff dizzy known revel exult bulge pulse
mossy: chaff pixel outdo snowy bossy mossy
staid: humor penne jazzy aback stall staff staid
hence: first jumbo dwell vegan penne hence
pinch: segue wryly idiot manic finch cinch pinch
teddy: along chime steep rebut jetty teddy
sully: chaff penne rowdy bitty gummy sulky sully
snore: chaff dizzy jumbo wooer grove store spore snore
ripen: chaff jumbo wedge vixen linen siren ripen
snowy: chaff pixel outdo gross smoky snowy
attic: humor penne dizzy flick tacit attic
going: chaff slump tweed kinky inbox groin going
leach: front slump vigil belly leech leach
mouth: drank pixel fussy couch bough mouth
hound: first llama gecko woozy pound bound hound
clump: front dizzy jewel alpha plump slump clump
tonal: spice jumbo floor dolly loath total tonal
bigot: chaff slump evoke dowdy onion rigor bigot
peril: chaff stern drove lemur repel peril
piece: along bused thyme prize pixie piece
blame: front dizzy sauce agape whale leave blame
haute: knoll dizzy refer swept butte chute haute
spied: along crumb sixth skiff seize spied
undid: chaff wryly point minim begin undid
intro: chaff slump wedge kinky robin intro
basal: front dizzy melee lupus shall basal
shine: float medic giver spike swine shine
gecko: shift llama purer ebony dodge gecko
rodeo: chaff tying buxom solve power rodeo
guard: shift carol rebar prawn quark guard
steer: along dizzy humph verve erect steer
loamy: shift queer blown polka local loamy
scamp: front dizzy basal shake spasm swamp scamp
scram: knoll dizzy fever brush straw scrap scram
manly: shift vodka augur place bylaw manly
hello: drank slump vigil lefty below cello hello
vaunt: spice wryly doubt haunt jaunt gaunt taunt vaunt
organ: shift bulky weave manor adorn organ
feral: vying jumbo chart paper wreak relax feral
knock: shift llama wedge juror boozy knock
extra: knoll dizzy segue crept threw extra
condo: shift llama evoke gourd downy condo
adapt: humor fanny clack stave await adapt
willy: chaff jumbo never dizzy sissy kitty piggy willy
polka: shift wryly label clank polka
rayon: shift pluck weave agora manor baron rayon
skirt: along beech jumpy visit wrist skirt
faith: knoll queer swamp tabby catch faith
torso: chaff pixel rugby storm worst torso
match: knoll dizzy augur theta stash batch watch catch hatch patch match
mercy: along shift dryer query jerky mercy
tepid: along fuzzy whisk river medic debit tepid
sleek: chaff tying rover embed jewel sleep sleek
riser: along erupt mercy where diver fiber riser
twixt: along queer dizzy skiff which twixt
peace: front dizzy label shave awake peace
flush: drank evict mogul blush slush plush flush
catty: humor abide fanny sassy gayly jazzy tatty patty catty
login: chaff queer smoky inbox owing dingo login
eject: along dizzy humph beset exert eject
roger: chaff stern eerie bluer wooer joker mover roger
rival: segue fanny chart ardor viral rival
untie: chaff wryly speed imbue quite untie
refit: along shuck dizzy tripe merit refit
aorta: spice flown jumbo toddy rotor aorta
adult: spice fanny brawl gloat adult
judge: chaff wryly onion upset queue budge judge
rower: chaff stern giver bluer wooer power mower rower
artsy: knoll beech dizzy pygmy rusty stray artsy
rural: shift vodka apply lager brawl mural rural
shave: front dizzy basal swash shake shame shape shave
